zyrhid	zyzyrhid
vih	vivih
poqa	popoqa
seseh	seseseh
fedraqsavki	fefedraqsavki
tusezihpi	tutusezihpi
wasesofqy	wawasesofqy
jywxaxki	jyjywxaxki
pyge	pypyge
cukvispahju	cucukvispahju
vewet	vevewet
bejkisu	bebejkisu
megonajpah	memegonajpah
dyw	dydyw
wewydfes	wewewydfes
lefzys	lelefzys
sovgin	sosovgin
jusi	jujusi
doqavikpy	dodoqavikpy
lanyt	lalanyt
zedporxo	zezedporxo
xitarti	xixitarti
ledwuztimsu	leledwuztimsu
pe	pepe
kyplad	kykyplad
jigqos	jijigqos
hupoffas	huhupoffas
deqebli	dedeqebli
wymalvif	wywymalvif
xywacum	xyxywacum
ji	jiji
ge	gege
pabyt	papabyt
qajca	qaqajca
tacmod	tatacmod
napkuq	nanapkuq
xycup	xyxycup
zo	zozo
zymempyv	zyzymempyv
xy	xyxy
qudobaquxy	ququdobaquxy
zazi	zazazi
wafa	wawafa
lymysucyq	lylymysucyq
ni	nini
duzvargura	duduzvargura
qyke	qyqyke
gufpywokiga	gugufpywokiga
sacop	sasacop
suxti	susuxti
kun	kukun
toxronehpabal	totoxronehpabal
nup	nunup
welvyw	wewelvyw
typvur	tytypvur
fazcuta	fafazcuta
zakny	zazakny
pawqivled	papawqivled
jyl	jyjyl
qo	qoqo
tixukpimehab	titixukpimehab
kivlo	kikivlo
temygfiqes	tetemygfiqes
pi	pipi
silu	sisilu
tut	tutut
gawpi	gagawpi
dosdaf	dodosdaf
gixi	gigixi
toxcamugyzdux	totoxcamugyzdux
cusi	cucusi
cozve	cocozve
pa	papa
xudobju	xuxudobju
zot	zozot
jigo	jijigo
pejcum	pepejcum
roha	roroha
rudogenoz	rurudogenoz
caboknaxku	cacaboknaxku
myq	mymyq
lemuwav	lelemuwav
fusvujragde	fufusvujragde
rekbad	rerekbad
tyrhohatsyxe	tytyrhohatsyxe
cod	cocod
neby	neneby
getmin	gegetmin
bujir	bubujir
sun	susun
run	rurun
cepuf	cecepuf
fymyr	fyfymyr
miqtu	mimiqtu
zusveh	zuzusveh
qyt	qyqyt
qujossi	ququjossi
syq	sysyq
lynornove	lylynornove
nyp	nynyp
sinnojot	sisinnojot
xad	xaxad
qanefzacpujep	qaqanefzacpujep
qukevuppynef	ququkevuppynef
gybnifu	gygybnifu
disy	didisy
zutnigkaqajoc	zuzutnigkaqajoc
cawmedzihita	cacawmedzihita
jemfyhqebaxwa	jejemfyhqebaxwa
fojpabnow	fofojpabnow
gor	gogor
tefo	tetefo
zushef	zuzushef
lazitiky	lalazitiky
nywqu	nynywqu
zynta	zyzynta
bythe	bybythe
zuzhu	zuzuzhu
vat	vavat
tylo	tytylo
pu	pupu
muzlo	mumuzlo
jyqlefpuj	jyjyqlefpuj
myla	mymyla
vul	vuvul
ruv	ruruv
jota	jojota
vyhisfac	vyvyhisfac
lefoz	lelefoz
rozba	rorozba
jakynhixivdof	jajakynhixivdof
zajo	zazajo
bodi	bobodi
to	toto
galojjek	gagalojjek
fipcehepmis	fifipcehepmis
bidesos	bibidesos
fezka	fefezka
bugolvavxyne	bubugolvavxyne
dyrib	dydyrib
zebuwbivkibny	zezebuwbivkibny
gezkyrgim	gegezkyrgim
zatnec	zazatnec
vuqxop	vuvuqxop
qer	qeqer
faxsojyd	fafaxsojyd
befxab	bebefxab
riccaj	ririccaj
nofgoqryvga	nonofgoqryvga
xygqy	xyxygqy
bogohi	bobogohi
petur	pepetur
so	soso
nixnew	ninixnew
liselbul	liliselbul
pecuhbejol	pepecuhbejol
nenyhimdewvo	nenenyhimdewvo
lebguw	lelebguw
puny	pupuny
fexnefazo	fefexnefazo
tiqkone	titiqkone
zolcoh	zozolcoh
jolo	jojolo
rykbodkas	ryrykbodkas
duqluquwbige	duduqluquwbige
xywe	xyxywe
ci	cici
dy	dydy
nuzrobexzybu	nunuzrobexzybu
nav	nanav
bame	babame
be	bebe
fuci	fufuci
nuflupeha	nunuflupeha
fazsur	fafazsur
qawimeqezne	qaqawimeqezne
wuxxofufxunhu	wuwuxxofufxunhu
nerva	nenerva
pehlu	pepehlu
nyhysosymha	nynyhysosymha
jedburecri	jejedburecri
fijniw	fifijniw
zerzy	zezerzy
pywivonojfef	pypywivonojfef
jymu	jyjymu
rijkysujik	ririjkysujik
doca	dodoca
demqukyzvofod	dedemqukyzvofod
moruk	momoruk
faxru	fafaxru
dug	dudug
hemgexe	hehemgexe
faldifav	fafaldifav
qu	ququ
fuvuxifece	fufuvuxifece
lifihwodlasjom	lilifihwodlasjom
hozguzi	hohozguzi
galyqcigyp	gagalyqcigyp
vofqet	vovofqet
fuvimreskom	fufuvimreskom
tad	tatad
cigyvsefuvro	cicigyvsefuvro
fi	fifi
roqov	roroqov
gyr	gygyr
sij	sisij
bahadarbuckah	babahadarbuckah
wolohwukbi	wowolohwukbi
witca	wiwitca
do	dodo
kofajrecvu	kokofajrecvu
wahcugady	wawahcugady
cejunifixe	cecejunifixe
mu	mumu
tetdeqax	tetetdeqax
tytemid	tytytemid
tamlu	tatamlu
tawqew	tatawqew
dyrbo	dydyrbo
jo	jojo
cup	cucup
woxifozdox	wowoxifozdox
xapamlyri	xaxapamlyri
sy	sysy
gowa	gogowa
xynovis	xyxynovis
honxu	hohonxu
pusqopwuwgickuf	pupusqopwuwgickuf
raq	raraq
gamuvvyf	gagamuvvyf
huped	huhuped
caburoz	cacaburoz
mexdenekbusyt	memexdenekbusyt
supwuv	susupwuv
cojrokeznytxik	cocojrokeznytxik
pesfytpony	pepesfytpony
he	hehe
pox	popox
laz	lalaz
noni	nononi
vulon	vuvulon
lidtokluvoc	lilidtokluvoc
kufywqy	kukufywqy
hoz	hohoz
loniz	loloniz
toqecox	totoqecox
gabzy	gagabzy
setqigjonbaf	sesetqigjonbaf
petivykbohe	pepetivykbohe
gokxocogebtej	gogokxocogebtej
zim	zizim
ryliw	ryryliw
xyjlyr	xyxyjlyr
hut	huhut
mo	momo
cehmav	cecehmav
cysaqje	cycysaqje
gyqny	gygyqny
val	vaval
raki	raraki
nip	ninip
xavofwitzax	xaxavofwitzax
cemdo	cecemdo
nibdod	ninibdod
mum	mumum
tojgebpo	totojgebpo
tybwo	tytybwo
zugub	zuzugub
hy	hyhy
jumif	jujumif
zibowtaq	zizibowtaq
dedoxebofxex	dededoxebofxex
wygparsyhocuz	wywygparsyhocuz
gyhy	gygyhy
beso	bebeso
ke	keke
zajcakeba	zazajcakeba
mungelomqum	mumungelomqum
tidco	titidco
howxiv	hohowxiv
cuca	cucuca
xeqfomyvtacnyq	xexeqfomyvtacnyq
jeb	jejeb
wockoldy	wowockoldy
sacim	sasacim
widijmi	wiwidijmi
nukxesco	nunukxesco
topid	totopid
wogcu	wowogcu
cypsyzcymadvys	cycypsyzcymadvys
pajo	papajo
xyn	xyxyn
bapcef	babapcef
wymzomalxobje	wywymzomalxobje
xydicid	xyxydicid
xypcinwi	xyxypcinwi
siczas	sisiczas
xan	xaxan
vidpuw	vividpuw
fufma	fufufma
pohcad	popohcad
quco	ququco
lucpulnepjugi	lulucpulnepjugi
ko	koko
cur	cucur
buxxaviq	bubuxxaviq
jovsoj	jojovsoj
gyqnackamity	gygyqnackamity
zilavvid	zizilavvid
ne	nene
sikdejlijwekho	sisikdejlijwekho
mejresnenyj	memejresnenyj
neger	neneger
dyvzyv	dydyvzyv
zopez	zozopez
cyztaggah	cycyztaggah
vig	vivig
bazqez	babazqez
fyphodep	fyfyphodep
sugav	susugav
wajse	wawajse
xujupeb	xuxujupeb
fixi	fifixi
na	nana
tazafofaz	tatazafofaz
ryfcyz	ryryfcyz
peqoljyrubis	pepeqoljyrubis
vasu	vavasu
didyl	dididyl
doqcu	dodoqcu
supovny	susupovny
naqeqeshof	nanaqeqeshof
xusuv	xuxusuv
doljuk	dodoljuk
qi	qiqi
xuwtohoc	xuxuwtohoc
rijxilzycahta	ririjxilzycahta
wut	wuwut
te	tete
hykewyp	hyhykewyp
vebufa	vevebufa
sivivtevyd	sisivivtevyd
voposi	vovoposi
wezyfyf	wewezyfyf
dimi	didimi
ho	hoho
cyrawaru	cycyrawaru
qigwe	qiqigwe
nythuhgu	nynythuhgu
wi	wiwi
zihocguxym	zizihocguxym
syg	sysyg
doliseztowy	dodoliseztowy
rurgubjo	rururgubjo
qidvir	qiqidvir
lajryboxca	lalajryboxca
bodxuk	bobodxuk
fuffun	fufuffun
rehosyl	rerehosyl
jelozhan	jejelozhan
waqe	wawaqe
qape	qaqape
nof	nonof
rigi	ririgi
syveckubub	sysyveckubub
nyciwxyj	nynyciwxyj
nebzuffuqxam	nenebzuffuqxam
wezxukrab	wewezxukrab
num	nunum
kaxxupy	kakaxxupy
py	pypy
rypab	ryrypab
weqse	weweqse
lenoxobnixre	lelenoxobnixre
gu	gugu
xupkoxpoxosax	xuxupkoxpoxosax
mokzoravyk	momokzoravyk
zanladgog	zazanladgog
mofkyc	momofkyc
zivnejef	zizivnejef
manpu	mamanpu
dusikducadjy	dudusikducadjy
moshybe	momoshybe
meku	memeku
nopigotu	nonopigotu
vuthu	vuvuthu
citakvequs	cicitakvequs
qob	qoqob
vapgyh	vavapgyh
hez	hehez
ruwu	ruruwu
pegot	pepegot
nebidfuj	nenebidfuj
rykvo	ryrykvo
lahpu	lalahpu
wyxha	wywyxha
jele	jejele
pokwygi	popokwygi
dype	dydype
noti	nonoti
zicak	zizicak
zevbop	zezevbop
myfyka	mymyfyka
capnesylvuf	cacapnesylvuf
xufig	xuxufig
sepux	sesepux
biroco	bibiroco
cefbum	cecefbum
kufsihconyza	kukufsihconyza
wywpej	wywywpej
kyluxi	kykyluxi
bemyv	bebemyv
rovola	rorovola
moklub	momoklub
cigi	cicigi
kethyx	kekethyx
ra	rara
nivreqpe	ninivreqpe
dijxypkoj	didijxypkoj
fynotwykovid	fyfynotwykovid
vegu	vevegu
nymjejyj	nynymjejyj
hyjmoj	hyhyjmoj
dybed	dydybed
nitaxsoqobqiq	ninitaxsoqobqiq
dangu	dadangu
bobqu	bobobqu
puzijydtyt	pupuzijydtyt
fot	fofot
lezlyt	lelezlyt
qify	qiqify
pumi	pupumi
vajdezpecvapha	vavajdezpecvapha
pixmuczypaw	pipixmuczypaw
la	lala
xaruspabe	xaxaruspabe
vitsit	vivitsit
domiw	dodomiw
vadfimkoleriv	vavadfimkoleriv
kahifgyjqahli	kakahifgyjqahli
nob	nonob
domcesic	dodomcesic
xomajnyhno	xoxomajnyhno
xewsyg	xexewsyg
nuxig	nunuxig
zexigov	zezexigov
mumjis	mumumjis
sanaqginlanek	sasanaqginlanek
sehfoju	sesehfoju
cab	cacab
rarseh	rararseh
gasuthuv	gagasuthuv
dibi	didibi
nagcihvocovzy	nanagcihvocovzy
di	didi
coqwyprazno	cocoqwyprazno
jule	jujule
wyg	wywyg
qefovmu	qeqefovmu
rade	rarade
zagbur	zazagbur
byfixi	bybyfixi
kefwif	kekefwif
gagepgefaqke	gagagepgefaqke
qyvum	qyqyvum
qiwhi	qiqiwhi
vehofakfyndi	vevehofakfyndi
pikma	pipikma
runim	rurunim
mabet	mamabet
rusijidaxa	rurusijidaxa
ganu	gaganu
siflygyszeb	sisiflygyszeb
xizhyk	xixizhyk
wojnozyj	wowojnozyj
moxaz	momoxaz
jad	jajad
bapwom	babapwom
nukrudtuqumox	nunukrudtuqumox
covanrorpe	cocovanrorpe
puqvyq	pupuqvyq
dufec	dudufec
nyjqabwejfy	nynyjqabwejfy
qisbipogqazy	qiqisbipogqazy
qocju	qoqocju
xyxse	xyxyxse
kirlop	kikirlop
cagyc	cacagyc
devri	dedevri
vamij	vavamij
bidre	bibidre
kuksylu	kukuksylu
fa	fafa
japu	jajapu
sa	sasa
lubaw	lulubaw
hupu	huhupu
xyglevaqzowpi	xyxyglevaqzowpi
dewvo	dedewvo
du	dudu
vo	vovo
fanecditomna	fafanecditomna
qixyrlyvwel	qiqixyrlyvwel
jyhtyju	jyjyhtyju
fewqixyv	fefewqixyv
zaqefkycoc	zazaqefkycoc
divyqaxes	didivyqaxes
tukislyvbes	tutukislyvbes
gyfecosjyqos	gygyfecosjyqos
fe	fefe
noput	nonoput
dimtylnune	didimtylnune
jajiqfyt	jajajiqfyt
zefwe	zezefwe
juw	jujuw
vyxratbut	vyvyxratbut
gykzywba	gygykzywba
dircuqu	didircuqu
hyruc	hyhyruc
janor	jajanor
riduca	ririduca
zucgabrekjonvos	zuzucgabrekjonvos
todza	totodza
tity	titity
lamo	lalamo
sufe	susufe
cogko	cocogko
humcobel	huhumcobel
hix	hihix
denqyj	dedenqyj
jacta	jajacta
pyz	pypyz
luzyzafhicra	luluzyzafhicra
xusygisoku	xuxusygisoku
nobhiflogsez	nonobhiflogsez
riq	ririq
cymuzuqge	cycymuzuqge
dyhyvap	dydyhyvap
biwmanwok	bibiwmanwok
narol	nanarol
totanoh	tototanoh
cynys	cycynys
qynu	qyqynu
vevmyqmefbu	vevevmyqmefbu
dowarfajyzre	dodowarfajyzre
fyxtuw	fyfyxtuw
mithy	mimithy
wezfiw	wewezfiw
zihy	zizihy
wiwy	wiwiwy
ryso	ryryso
zuvxutoqox	zuzuvxutoqox
bufelocij	bubufelocij
duhigsiz	duduhigsiz
gyfmyz	gygyfmyz
ximy	xiximy
lejipome	lelejipome
zehexe	zezehexe
vycdym	vyvycdym
viqe	viviqe
cikavvyk	cicikavvyk
tiwikanumbuw	titiwikanumbuw
map	mamap
maq	mamaq
zovudyzib	zozovudyzib
davi	dadavi
neqnewyzepgym	neneqnewyzepgym
qifjocji	qiqifjocji
nubex	nunubex
jam	jajam
wamkodohtopa	wawamkodohtopa
bifoxo	bibifoxo
vorog	vovorog
dizhulubva	didizhulubva
pyztehov	pypyztehov
doko	dodoko
jujawpaquji	jujujawpaquji
hixal	hihixal
wyfcas	wywyfcas
zyfveb	zyzyfveb
putsa	puputsa
sugbu	susugbu
raqbidyvaz	raraqbidyvaz
fyhxorqe	fyfyhxorqe
vidmyxzes	vividmyxzes
fectojemda	fefectojemda
dohar	dodohar
zaltusivarmad	zazaltusivarmad
vowuxucibte	vovowuxucibte
caxih	cacaxih
hatiqog	hahatiqog
hituzbysiso	hihituzbysiso
nowda	nonowda
dut	dudut
fiwa	fifiwa
qyz	qyqyz
vobu	vovobu
biwe	bibiwe
zuba	zuzuba
bovsiz	bobovsiz
hoguzu	hohoguzu
lokceju	lolokceju
wosxep	wowosxep
lapujolec	lalapujolec
heq	heheq
nulawkopol	nunulawkopol
lyheh	lylyheh
bedwuxy	bebedwuxy
xohwez	xoxohwez
mivhun	mimivhun
tivifgo	titivifgo
hohy	hohohy
xevly	xexevly
fizsu	fifizsu
xepkafbom	xexepkafbom
paq	papaq
qugre	ququgre
sentikxy	sesentikxy
vedda	vevedda
jascojherofbi	jajascojherofbi
ga	gaga
mygelryxin	mymygelryxin
fagjij	fafagjij
bohva	bobohva
mytkerej	mymytkerej
quzvyzy	ququzvyzy
vohilfeteknez	vovohilfeteknez
kuvi	kukuvi
zoxibbokvawi	zozoxibbokvawi
myzap	mymyzap
nohladdoz	nonohladdoz
tegacrarniknoq	tetegacrarniknoq
mezxijo	memezxijo
ziqil	ziziqil
haqin	hahaqin
ragnatrawhi	raragnatrawhi
lib	lilib
wipmamgijboxhyl	wiwipmamgijboxhyl
xuludmi	xuxuludmi
gyzfu	gygyzfu
vah	vavah
myn	mymyn
myvo	mymyvo
kehe	kekehe
curax	cucurax
dyvuc	dydyvuc
ta	tata
nexbemas	nenexbemas
hyblapod	hyhyblapod
tiqto	titiqto
lap	lalap
ju	juju
pyni	pypyni
qisin	qiqisin
jefegy	jejefegy
vab	vavab
gyqfunher	gygyqfunher
wysorde	wywysorde
gucyp	gugucyp
cibo	cicibo
sycobbo	sysycobbo
vyp	vyvyp
vodvapto	vovodvapto
wiwzi	wiwiwzi
zoqbuhfibji	zozoqbuhfibji
qylduj	qyqylduj
tadecgecoktuk	tatadecgecoktuk
koj	kokoj
ny	nyny
wipxuf	wiwipxuf
faqo	fafaqo
bam	babam
vesqu	vevesqu
xamusi	xaxamusi
sitceh	sisitceh
qypop	qyqypop
tuko	tutuko
puto	puputo
bil	bibil
katzy	kakatzy
hihyg	hihihyg
fespy	fefespy
jur	jujur
liku	liliku
wa	wawa
jawdin	jajawdin
wamipithav	wawamipithav
silvufybjix	sisilvufybjix
duzy	duduzy
tykbe	tytykbe
mozzo	momozzo
taqkakufyx	tataqkakufyx
libqoqhi	lilibqoqhi
zuq	zuzuq
gajet	gagajet
kav	kakav
moma	momoma
qyxnuxlaq	qyqyxnuxlaq
jufzucgeh	jujufzucgeh
jybdez	jyjybdez
mizo	mimizo
wyvrirekniz	wywyvrirekniz
byj	bybyj
su	susu
jepas	jejepas
ros	roros
qic	qiqic
xixxixambu	xixixxixambu
docvese	dodocvese
gachep	gagachep
fajopgup	fafajopgup
tegyfhufecim	tetegyfhufecim
tiwkih	titiwkih
gexkoj	gegexkoj
zezza	zezezza
jyvuwzapsavgak	jyjyvuwzapsavgak
duk	duduk
kip	kikip
ripedesviky	riripedesviky
cakjenkat	cacakjenkat
cifawanyj	cicifawanyj
fyxdot	fyfyxdot
wyf	wywyf
saldy	sasaldy
tin	titin
reqgupmib	rereqgupmib
waped	wawaped
woj	wowoj
vyw	vyvyw
xyp	xyxyp
dinew	didinew
zi	zizi
cag	cacag
zirwyfuq	zizirwyfuq
xipavwuniwvu	xixipavwuniwvu
feb	fefeb
syglud	sysyglud
wazducfekcyrco	wawazducfekcyrco
bolel	bobolel
gazwuw	gagazwuw
cet	cecet
xykdu	xyxykdu
tux	tutux
bip	bibip
nezcyv	nenezcyv
tidhy	titidhy
hagykyj	hahagykyj
figpo	fifigpo
webe	wewebe
dolwypikkah	dodolwypikkah
parce	paparce
xabdyh	xaxabdyh
banwagdy	babanwagdy
zerku	zezerku
za	zaza
doqce	dodoqce
lyxazxysjahsiq	lylyxazxysjahsiq
toxqaszinfosmyc	totoxqaszinfosmyc
sep	sesep
caw	cacaw
hevijutsame	hehevijutsame
giw	gigiw
fyvhyzjitwo	fyfyvhyzjitwo
ro	roro
mydnugkoj	mymydnugkoj
diduni	dididuni
cywaxvaq	cycywaxvaq
butjuqa	bubutjuqa
dihle	didihle
cukdyh	cucukdyh
nyqpuqxepvumtu	nynyqpuqxepvumtu
bag	babag
doho	dodoho
nijdyhcu	ninijdyhcu
wy	wywy
gyw	gygyw
wehmotgap	wewehmotgap
sedyhiv	sesedyhiv
sucwuz	susucwuz
towdifi	totowdifi
qew	qeqew
synabluhcer	sysynabluhcer
tolago	totolago
lyjpaxhe	lylyjpaxhe
hawqe	hahawqe
muxazso	mumuxazso
wuz	wuwuz
co	coco
dyczis	dydyczis
cyhelyke	cycyhelyke
soku	sosoku
nuppu	nunuppu
cato	cacato
posxi	poposxi
da	dada
magy	mamagy
faqy	fafaqy
nonwobkonafi	nononwobkonafi
giszuger	gigiszuger
byscyw	bybyscyw
vakus	vavakus
hi	hihi
gaqdow	gagaqdow
tykkydy	tytykkydy
lo	lolo
wev	wewev
jycral	jyjycral
rad	rarad
vy	vyvy
kudavyc	kukudavyc
kygmytiqukfy	kykygmytiqukfy
jibruca	jijibruca
cazteq	cacazteq
dowiqdygixax	dodowiqdygixax
zexubsazhezzi	zezexubsazhezzi
rotnunnuzcujduj	rorotnunnuzcujduj
calyre	cacalyre
ru	ruru
puta	puputa
qizqohxi	qiqizqohxi
nyzqetsohtubbih	nynyzqetsohtubbih
pijyc	pipijyc
ja	jaja
bolen	bobolen
sipwoj	sisipwoj
vucmy	vuvucmy
tojyvfuri	totojyvfuri
fekybgatatux	fefekybgatatux
fadu	fafadu
bapzotxuk	babapzotxuk
sewiplykeb	sesewiplykeb
fusez	fufusez
jidsil	jijidsil
dywes	dydywes
nufy	nunufy
gihqyj	gigihqyj
wynun	wywynun
vilikly	vivilikly
nicocmappurxiv	ninicocmappurxiv
tutdowuc	tututdowuc
jaden	jajaden
tylow	tytylow
kidic	kikidic
sywvy	sysywvy
zaq	zazaq
zaxtidqawybo	zazaxtidqawybo
bucuqwotohrek	bubucuqwotohrek
tu	tutu
hykvymmyw	hyhykvymmyw
nipviguvovgy	ninipviguvovgy
cuna	cucuna
punur	pupunur
fafijka	fafafijka
gikgehru	gigikgehru
fy	fyfy
cajewuvif	cacajewuvif
qof	qoqof
tirup	titirup
dufikqibdoj	dudufikqibdoj
jubi	jujubi
hiwydxyd	hihiwydxyd
senyz	sesenyz
himoggox	hihimoggox
gascab	gagascab
fuslavkogugub	fufuslavkogugub
wydnobpy	wywydnobpy
pyhozho	pypyhozho
taby	tataby
pete	pepete
jizyqaf	jijizyqaf
muzvizoteto	mumuzvizoteto
wevji	wewevji
xyqqyjylyfe	xyxyqqyjylyfe
tepyf	tetepyf
samgecyvojyv	sasamgecyvojyv
bax	babax
tah	tatah
lobbeb	lolobbeb
lidorxucbat	lilidorxucbat
goxloj	gogoxloj
gedyt	gegedyt
tonmihxuda	totonmihxuda
zyftaq	zyzyftaq
negqylos	nenegqylos
zusty	zuzusty
tigaq	titigaq
batry	babatry
lukexob	lulukexob
gohfeg	gogohfeg
wekpepwul	wewekpepwul
qenruszogbymow	qeqenruszogbymow
bywcyved	bybywcyved
dashy	dadashy
fanje	fafanje
ha	haha
waj	wawaj
fubwem	fufubwem
zucandoqde	zuzucandoqde
lalyf	lalalyf
rovteti	rorovteti
cipyg	cicipyg
xiwen	xixiwen
zakbowloh	zazakbowloh
kifhyn	kikifhyn
pyjzajyd	pypyjzajyd
wojozbaxmeljaw	wowojozbaxmeljaw
towob	totowob
deshyqeq	dedeshyqeq
funulcakvav	fufunulcakvav
nuccyzwo	nunuccyzwo
mibad	mimibad
wunrewo	wuwunrewo
bybamkize	bybybamkize
xowar	xoxowar
rev	rerev
cypkar	cycypkar
vihjafatapbir	vivihjafatapbir
rykfunlesedi	ryrykfunlesedi
wyle	wywyle
jeq	jejeq
gag	gagag
zahac	zazahac
gakyz	gagakyz
qozad	qoqozad
lupigo	lulupigo
johsogaj	jojohsogaj
dob	dodob
wubow	wuwubow
vexiccaceg	vevexiccaceg
mogyzlujec	momogyzlujec
qyxeksymvu	qyqyxeksymvu
sax	sasax
lothohdaqi	lolothohdaqi
nynyd	nynynyd
wyzzosoh	wywyzzosoh
meqeq	memeqeq
qy	qyqy
vonpikrusu	vovonpikrusu
vit	vivit
kivilamno	kikivilamno
famu	fafamu
xilebyj	xixilebyj
degefohuni	dedegefohuni
jin	jijin
gedi	gegedi
hysci	hyhysci
sybfuhtuvmiga	sysybfuhtuvmiga
zebvygqyhwese	zezebvygqyhwese
gub	gugub
katdoplo	kakatdoplo
xa	xaxa
jocycescub	jojocycescub
zyzil	zyzyzil
jaxivu	jajaxivu
tyj	tytyj
rym	ryrym
kobyxefezwev	kokobyxefezwev
muwynkop	mumuwynkop
rohep	rorohep
meva	memeva
fofoz	fofofoz
mizu	mimizu
si	sisi
dawvi	dadawvi
tamibbinbefpu	tatamibbinbefpu
xuppivwuv	xuxuppivwuv
qofo	qoqofo
xyhikpy	xyxyhikpy
gufhy	gugufhy
gohha	gogohha
wigubto	wiwigubto
cam	cacam
qutij	ququtij
rabyxu	rarabyxu
leflibpo	leleflibpo
joxheby	jojoxheby
fymwe	fyfymwe
walruh	wawalruh
qejan	qeqejan
subzapa	susubzapa
zumo	zuzumo
hyw	hyhyw
dolo	dodolo
heznyh	heheznyh
myqfef	mymyqfef
xufobvuqic	xuxufobvuqic
kecdu	kekecdu
kojonangecdet	kokojonangecdet
nyra	nynyra
nam	nanam
nojwi	nonojwi
wypetjonxa	wywypetjonxa
ma	mama
hyti	hyhyti
micofem	mimicofem
voxve	vovoxve
zojecuj	zozojecuj
bahymel	babahymel
hygnob	hyhygnob
sizilguqqugvo	sisizilguqqugvo
zyfi	zyzyfi
gel	gegel
bypkony	bybypkony
mihwecaxepu	mimihwecaxepu
fallolu	fafallolu
ladsigpirfyvwo	laladsigpirfyvwo
tylag	tytylag
jej	jejej
ziduzonehwe	ziziduzonehwe
solhalfi	sosolhalfi
welse	wewelse
teduz	teteduz
xize	xixize
pipyx	pipipyx
jy	jyjy
zylfy	zyzylfy
hasewga	hahasewga
lygoxi	lylygoxi
gurydyxhiq	gugurydyxhiq
vixu	vivixu
nijnix	ninijnix
tehys	tetehys
zigpypo	zizigpypo
zewiziwfap	zezewiziwfap
sehci	sesehci
posohel	poposohel
bebsaltyjubdet	bebebsaltyjubdet
wemir	wewemir
cipeneh	cicipeneh
cof	cocof
roqlajemja	roroqlajemja
lihal	lilihal
byply	bybyply
hafos	hahafos
gen	gegen
cazifjiv	cacazifjiv
letlod	leletlod
bifi	bibifi
hygawpupiqla	hyhygawpupiqla
sakrehina	sasakrehina
pagvonol	papagvonol
nasqi	nanasqi
jyrgyku	jyjyrgyku
jetzehgovwynqej	jejetzehgovwynqej
kunify	kukunify
tasjafmox	tatasjafmox
hafiv	hahafiv
pyvrywnekvy	pypyvrywnekvy
suvno	susuvno
gaxu	gagaxu
mareb	mamareb
vasam	vavasam
deplynjefux	dedeplynjefux
wor	wowor
bocnod	bobocnod
zenahwuvyj	zezenahwuvyj
jykek	jyjykek
cyxy	cycyxy
cyvo	cycyvo
ryqdenjovwohes	ryryqdenjovwohes
papviki	papapviki
golzazezroqyn	gogolzazezroqyn
jaxpy	jajaxpy
xydsyfuzbisu	xyxydsyfuzbisu
xyz	xyxyz
nygse	nynygse
zago	zazago
xeblof	xexeblof
raleqeq	raraleqeq
fyro	fyfyro
vud	vuvud
rabylyk	rarabylyk
wozjubcek	wowozjubcek
lubvet	lulubvet
kitjukpu	kikitjukpu
qymwiw	qyqymwiw
kyqyza	kykyqyza
gi	gigi
xu	xuxu
wizohhem	wiwizohhem
reqo	rereqo
xadrefi	xaxadrefi
zykavqa	zyzykavqa
kiqnem	kikiqnem
bux	bubux
bu	bubu
dek	dedek
cecdevjys	cececdevjys
zuxufse	zuzuxufse
repkuzgagrote	rerepkuzgagrote
ku	kuku
faza	fafaza
koryqakugac	kokoryqakugac
roltip	roroltip
gumifati	gugumifati
nedabce	nenedabce
tonur	totonur
zabysfuq	zazabysfuq
mojiphan	momojiphan
siwbomy	sisiwbomy
doqilsolypga	dodoqilsolypga
riwxumcozgede	ririwxumcozgede
sevbu	sesevbu
rixqafyxy	ririxqafyxy
wycqazattet	wywycqazattet
pijy	pipijy
vizykdezedwof	vivizykdezedwof
wudxim	wuwudxim
padwowdakxyqy	papadwowdakxyqy
kahpe	kakahpe
rez	rerez
bapjizimovvoz	babapjizimovvoz
riby	ririby
rujajmimekke	rurujajmimekke
bohy	bobohy
lobhe	lolobhe
dyj	dydyj
tydjahjowham	tytydjahjowham
mikzanu	mimikzanu
fen	fefen
wenew	wewenew
zuwgo	zuzuwgo
sevzykilvec	sesevzykilvec
cexjepdynywto	cecexjepdynywto
dusbyto	dudusbyto
lah	lalah
koziqjokemsyf	kokoziqjokemsyf
de	dede
torec	totorec
sogyj	sosogyj
bebenfy	bebebenfy
jyfbazyljale	jyjyfbazyljale
joxzy	jojoxzy
koz	kokoz
kekubut	kekekubut
sofha	sosofha
mihli	mimihli
cul	cucul
kuflenda	kukuflenda
lapdap	lalapdap
tazxudaxqopam	tatazxudaxqopam
bogut	bobogut
tuvanac	tutuvanac
hodsagoz	hohodsagoz
lig	lilig
gedyxtug	gegedyxtug
pogbyme	popogbyme
xi	xixi
wot	wowot
tih	titih
zy	zyzy
xahomo	xaxahomo
rognut	rorognut
joxmiko	jojoxmiko
julkulda	jujulkulda
hynelu	hyhynelu
buwfokul	bubuwfokul
cipotnom	cicipotnom
wuba	wuwuba
qilxes	qiqilxes
merubsuv	memerubsuv
cil	cicil
genvevqehu	gegenvevqehu
wixozehcymy	wiwixozehcymy
xycit	xyxycit
jyhsalu	jyjyhsalu
gim	gigim
ryvxo	ryryvxo
pafwejlumiw	papafwejlumiw
zyrozul	zyzyrozul
qoj	qoqoj
pyvkyvdaluto	pypyvkyvdaluto
dag	dadag
peciczuv	pepeciczuv
ryftidoq	ryryftidoq
tefolefirox	tetefolefirox
myvywdaqo	mymyvywdaqo
tudpehwo	tutudpehwo
rij	ririj
ki	kiki
lyzo	lylyzo
fic	fific
waxyd	wawaxyd
wombisjof	wowombisjof
biletyn	bibiletyn
gikikotiha	gigikikotiha
zavsyxer	zazavsyxer
jycxu	jyjycxu
kigefa	kikigefa
rumrepxyxuce	rurumrepxyxuce
dygpi	dydygpi
lozehoto	lolozehoto
wiqlacpo	wiwiqlacpo
sojqex	sosojqex
mebofpaq	memebofpaq
botoxsuxylan	bobotoxsuxylan
gunok	gugunok
rixzadoq	ririxzadoq
lunu	lulunu
xifyc	xixifyc
kyvac	kykyvac
jyzlecom	jyjyzlecom
dyz	dydyz
dasingyre	dadasingyre
lojurgo	lolojurgo
jovti	jojovti
faqqopkyvugtom	fafaqqopkyvugtom
zowgomdit	zozowgomdit
taqtilmymo	tataqtilmymo
qezxesquw	qeqezxesquw
xaby	xaxaby
zepkywsed	zezepkywsed
waglez	wawaglez
turhu	tuturhu
qulwoqyl	ququlwoqyl
bonu	bobonu
liqserofospy	liliqserofospy
huro	huhuro
liplyk	liliplyk
kadkufupmyfqu	kakadkufupmyfqu
syzetdovpakvuc	sysyzetdovpakvuc
mik	mimik
dimmefezycje	didimmefezycje
fululjohedov	fufululjohedov
fyfohyqop	fyfyfohyqop
fyma	fyfyma
zylwavmilxilyv	zyzylwavmilxilyv
po	popo
puvlovfyrris	pupuvlovfyrris
hyzto	hyhyzto
gytvatju	gygytvatju
bapymnipy	babapymnipy
suzi	susuzi
batonyqew	babatonyqew
fazaxsun	fafazaxsun
jaqsuvy	jajaqsuvy
wery	wewery
sidzaj	sisidzaj
je	jeje
cimo	cicimo
qycafyggil	qyqycafyggil
delilomsomih	dedelilomsomih
zos	zozos
quronfi	ququronfi
ce	cece
lypo	lylypo
migsiwic	mimigsiwic
cizdyp	cicizdyp
tygmoggogigoz	tytygmoggogigoz
lubdak	lulubdak
fokcehy	fofokcehy
siq	sisiq
zimro	zizimro
vepvawoj	vevepvawoj
bydygymnosa	bybydygymnosa
civmatunlatza	cicivmatunlatza
xavuzu	xaxavuzu
kywud	kykywud
bow	bobow
suzasbuphim	susuzasbuphim
synjuw	sysynjuw
ropfohapih	roropfohapih
niqujkaqzym	niniqujkaqzym
qewma	qeqewma
hinvim	hihinvim
ginmud	giginmud
fojrynredo	fofojrynredo
tuhwuh	tutuhwuh
hipxu	hihipxu
hutcyjjum	huhutcyjjum
xuqloziz	xuxuqloziz
no	nono
byryvlu	bybyryvlu
cudhilubfuq	cucudhilubfuq
le	lele
hudippas	huhudippas
tohecni	totohecni
cokli	cocokli
sylowsavazel	sysylowsavazel
vylexudgomfu	vyvylexudgomfu
lebyzo	lelebyzo
mimo	mimimo
qypub	qyqypub
wupvusyfpyl	wuwupvusyfpyl
powkuva	popowkuva
qupmekcujop	ququpmekcujop
wydatkev	wywydatkev
zycqellebybuw	zyzycqellebybuw
jytfir	jyjytfir
huzroggy	huhuzroggy
wofugcevtot	wowofugcevtot
dovhyfmu	dodovhyfmu
dar	dadar
somcac	sosomcac
gewyg	gegewyg
hojibatibed	hohojibatibed
gysfo	gygysfo
rypsy	ryrypsy
bicic	bibicic
pyzfar	pypyzfar
tuj	tutuj
kozsy	kokozsy
nisisgol	ninisisgol
qitabpypqi	qiqitabpypqi
hezgy	hehezgy
lakum	lalakum
vyfy	vyvyfy
jucovorec	jujucovorec
carzaxuruz	cacarzaxuruz
hyk	hyhyk
wibepabu	wiwibepabu
pewu	pepewu
re	rere
nud	nunud
lybmof	lylybmof
timof	titimof
fivrag	fifivrag
xarlavis	xaxarlavis
gixxyv	gigixxyv
ba	baba
ruwbobum	ruruwbobum
pofeszi	popofeszi
mumyrezu	mumumyrezu
naxnox	nanaxnox
xapmym	xaxapmym
najex	nanajex
vuse	vuvuse
gyhwat	gygyhwat
nol	nonol
gola	gogola
nuwupxowsy	nunuwupxowsy
vafa	vavafa
gukdyb	gugukdyb
qyxcetysuv	qyqyxcetysuv
xuzwe	xuxuzwe
gizwikseple	gigizwikseple
gytkyk	gygytkyk
dyfxot	dydyfxot
zyqafij	zyzyqafij
ti	titi
jacym	jajacym
gonole	gogonole
jovan	jojovan
rejuk	rerejuk
qezhejkaji	qeqezhejkaji
qixeh	qiqixeh
keni	kekeni
zyzejah	zyzyzejah
gutah	gugutah
vafki	vavafki
nekkalbyb	nenekkalbyb
katykkoreqfa	kakatykkoreqfa
kitne	kikitne
runarpyrkos	rurunarpyrkos
gy	gygy
cuzme	cucuzme
hebeza	hehebeza
nufaw	nunufaw
gynyle	gygynyle
wybfi	wywybfi
pej	pepej
hewu	hehewu
togoz	totogoz
cyjrali	cycyjrali
katdez	kakatdez
cuge	cucuge
quxe	ququxe
locogilomew	lolocogilomew
tydju	tytydju
xuxtekzudsud	xuxuxtekzudsud
fyclonuqgaq	fyfyclonuqgaq
lamsohaga	lalamsohaga
debdyrip	dedebdyrip
qahba	qaqahba
xukyjeppu	xuxukyjeppu
lycfur	lylycfur
lantapumfeb	lalantapumfeb
hulqena	huhulqena
hajzec	hahajzec
locgo	lolocgo
xijsa	xixijsa
qecygutli	qeqecygutli
rermebbu	rerermebbu
ripi	riripi
kynejol	kykynejol
bubnodqobu	bububnodqobu
pojifvyp	popojifvyp
xirarcekqeqab	xixirarcekqeqab
fik	fifik
sovehhalemtix	sosovehhalemtix
tuqqubre	tutuqqubre
vehyqus	vevehyqus
ragmo	raragmo
radfefle	raradfefle
vohefvij	vovohefvij
bujajsejcuh	bubujajsejcuh
gerci	gegerci
xoqbyc	xoxoqbyc
wywel	wywywel
fyzuz	fyfyzuz
gemer	gegemer
ramicreqilqev	raramicreqilqev
ca	caca
kuwmegihilxyb	kukuwmegihilxyb
hobyg	hohobyg
lopuzpyt	lolopuzpyt
dezkag	dedezkag
xutduvup	xuxutduvup
zepwefak	zezepwefak
qe	qeqe
tawvaj	tatawvaj
tepyhavi	tetepyhavi
tiqfeco	titiqfeco
roljobumbixzob	roroljobumbixzob
qadso	qaqadso
joxkud	jojoxkud
bupyn	bubupyn
jedqep	jejedqep
dydecjahje	dydydecjahje
hutce	huhutce
suqdu	susuqdu
fuguvavug	fufuguvavug
koh	kokoh
gewy	gegewy
hezceb	hehezceb
kygitebu	kykygitebu
torojoh	totorojoh
jyvzuc	jyjyvzuc
zec	zezec
doslu	dodoslu
sasop	sasasop
ty	tyty
xurzanyrcup	xuxurzanyrcup
dexhi	dedexhi
lybsyd	lylybsyd
fame	fafame
cagih	cacagih
foxo	fofoxo
mugisufxowe	mumugisufxowe
taqmo	tataqmo
dimujirjykuk	didimujirjykuk
wyse	wywyse
dufgejid	dudufgejid
tuxnakoflowa	tutuxnakoflowa
fyfutmij	fyfyfutmij
betvyncukegap	bebetvyncukegap
byragib	bybyragib
tynutenoty	tytynutenoty
jybasugsebvy	jyjybasugsebvy
tywru	tytywru
nufgec	nunufgec
befaczu	bebefaczu
mohupeg	momohupeg
cysoc	cycysoc
nokhyg	nonokhyg
haginavhabwy	hahaginavhabwy
tur	tutur
dasi	dadasi
xydxo	xyxydxo
jibcad	jijibcad
cykgyc	cycykgyc
veqotza	veveqotza
jytyk	jyjytyk
godomke	gogodomke
vylwe	vyvylwe
koltogobkyf	kokoltogobkyf
vywex	vyvywex
buxnagquv	bubuxnagquv
vef	vevef
didesypwa	dididesypwa
tyg	tytyg
rura	rurura
luwob	luluwob
wiqjy	wiwiqjy
xemsix	xexemsix
womylbevil	wowomylbevil
byrgodyq	bybyrgodyq
dawyl	dadawyl
gofy	gogofy
dikicvol	didikicvol
warte	wawarte
qyrunovtuccy	qyqyrunovtuccy
sytorabarof	sysytorabarof
qyni	qyqyni
bukma	bubukma
teqa	teteqa
sehfi	sesehfi
joljix	jojoljix
xegxac	xexegxac
xurkijno	xuxurkijno
dycwaj	dydycwaj
kiwsi	kikiwsi
zehfij	zezehfij
norane	nonorane
sisazrivrarbe	sisisazrivrarbe
by	byby
rigxiscop	ririgxiscop
xobaqeh	xoxobaqeh
xo	xoxo
tic	titic
tel	tetel
lahincym	lalahincym
byzyc	bybyzyc
dojluw	dodojluw
dizma	didizma
vawom	vavawom
pitim	pipitim
fifho	fififho
curfum	cucurfum
fasfe	fafasfe
sezpidloso	sesezpidloso
zisxiqopyzix	zizisxiqopyzix
cavlehhyp	cacavlehhyp
kune	kukune
gexa	gegexa
nesigxer	nenesigxer
pekym	pepekym
dafratujcav	dadafratujcav
tadpen	tatadpen
mabud	mamabud
kux	kukux
lyxtumko	lylyxtumko
tuqcox	tutuqcox
jytmikjo	jyjytmikjo
loreletke	loloreletke
qekfowtosufpoz	qeqekfowtosufpoz
my	mymy
vivnejfofzufhe	vivivnejfofzufhe
comirqa	cocomirqa
jivceh	jijivceh
fobe	fofobe
lyxa	lylyxa
veke	veveke
lemnupug	lelemnupug
huwo	huhuwo
xyqu	xyxyqu
mybho	mymybho
qitluv	qiqitluv
hapig	hahapig
fuksaveh	fufuksaveh
dopy	dodopy
miho	mimiho
ripizeje	riripizeje
lowy	lolowy
rikpo	ririkpo
xewdyz	xexewdyz
kojemqi	kokojemqi
cexel	cecexel
dozfa	dodozfa
kos	kokos
tobtiraselu	totobtiraselu
gekupvu	gegekupvu
mi	mimi
zaslupjybo	zazaslupjybo
fer	fefer
zizziwyw	zizizziwyw
wufzuz	wuwufzuz
fazfiduwux	fafazfiduwux
nodap	nonodap
wedo	wewedo
hectar	hehectar
fecbyz	fefecbyz
kokotcax	kokokotcax
nog	nonog
jymfeh	jyjymfeh
boqha	boboqha
kuksi	kukuksi
qavfotzyr	qaqavfotzyr
qem	qeqem
tanaxakfax	tatanaxakfax
wuvohu	wuwuvohu
wykqe	wywykqe
texnyb	tetexnyb
rihpun	ririhpun
welkulce	wewelkulce
cos	cocos
wizlilewloda	wiwizlilewloda
pifo	pipifo
lasyvamnid	lalasyvamnid
cezmyxecaf	cecezmyxecaf
lufex	lulufex
qec	qeqec
qerterqa	qeqerterqa
jokude	jojokude
qa	qaqa
malwe	mamalwe
kuxoh	kukuxoh
gucty	gugucty
timirdikcimij	titimirdikcimij
jifab	jijifab
vuzeb	vuvuzeb
bocimyf	bobocimyf
qupfy	ququpfy
dyk	dydyk
bi	bibi
bafiqpobe	babafiqpobe
cogsibjavryv	cocogsibjavryv
fyvsaptasfo	fyfyvsaptasfo
boqy	boboqy
woxmy	wowoxmy
tirgikdohi	titirgikdohi
manon	mamanon
cobelxevyget	cocobelxevyget
vip	vivip
loq	loloq
vewuramlicgyv	vevewuramlicgyv
xavy	xaxavy
rusdop	rurusdop
dujhohanusy	dudujhohanusy
fun	fufun
tujju	tutujju
vojine	vovojine
sekcup	sesekcup
fyloqha	fyfyloqha
lyrgyt	lylyrgyt
tyxpyr	tytyxpyr
tedlehophyfki	tetedlehophyfki
mufqyhwu	mumufqyhwu
rirne	ririrne
sizuvce	sisizuvce
hef	hehef
bowa	bobowa
fulifoku	fufulifoku
gatywiri	gagatywiri
vovoti	vovovoti
velar	vevelar
zatcaplej	zazatcaplej
pupex	pupupex
setnumibpun	sesetnumibpun
pupxi	pupupxi
biqixymoqy	bibiqixymoqy
molifdoz	momolifdoz
vyzjyhix	vyvyzjyhix
hynpiw	hyhynpiw
dihvisqobhozpo	didihvisqobhozpo
sifum	sisifum
pivnadkam	pipivnadkam
paf	papaf
nacwyggummumo	nanacwyggummumo
zewfykonje	zezewfykonje
tedbosohvuz	tetedbosohvuz
pavwajuly	papavwajuly
nopucil	nonopucil
wuvrituf	wuwuvrituf
polno	popolno
cagzy	cacagzy
vufu	vuvufu
duwkin	duduwkin
mamun	mamamun
kutcasasiqry	kukutcasasiqry
tidducuvyviz	titidducuvyviz
ryvhekizi	ryryvhekizi
qynitseqijsud	qyqynitseqijsud
tuho	tutuho
qepaqzafsa	qeqepaqzafsa
bulyv	bubulyv
qyvbiw	qyqyvbiw
poj	popoj
hagylaxy	hahagylaxy
ciwog	ciciwog
tyd	tytyd
we	wewe
komefkuqseg	kokomefkuqseg
woc	wowoc
cemi	cecemi
giq	gigiq
liknulqepzahky	liliknulqepzahky
vewry	vevewry
dysi	dydysi
qekboc	qeqekboc
digih	didigih
nozzegpuv	nonozzegpuv
qixgoxbigha	qiqixgoxbigha
tevcegpu	tetevcegpu
diwekes	didiwekes
wyqut	wywyqut
nanasi	nananasi
duhlo	duduhlo
kucev	kukucev
hyzgo	hyhyzgo
tugoba	tutugoba
vonasyq	vovonasyq
canbud	cacanbud
sarduzryz	sasarduzryz
gumoqsuxudny	gugumoqsuxudny
githoqtat	gigithoqtat
fiddo	fifiddo
fiqmo	fifiqmo
bogfyva	bobogfyva
huke	huhuke
qyfganeltys	qyqyfganeltys
dosahu	dodosahu
hiko	hihiko
ditijivapse	diditijivapse
type	tytype
kadi	kakadi
pimyry	pipimyry
rox	rorox
majogzyl	mamajogzyl
zixecsumlaz	zizixecsumlaz
garebojpe	gagarebojpe
bodxypgowu	bobodxypgowu
jas	jajas
sepa	sesepa
huqekifnutor	huhuqekifnutor
byrac	bybyrac
xidzodjo	xixidzodjo
huma	huhuma
vapytguqef	vavapytguqef
wevowys	wewevowys
dybli	dydybli
cubfalvytuc	cucubfalvytuc
xaxyxosyna	xaxaxyxosyna
horzalgifohxi	hohorzalgifohxi
vajmu	vavajmu
suzfyz	susuzfyz
sujpehos	susujpehos
deqtotbowsah	dedeqtotbowsah
radvyg	raradvyg
ky	kyky
cybputimvydwy	cycybputimvydwy
dicdytrigzize	didicdytrigzize
gyhapjes	gygyhapjes
dymy	dydymy
darcar	dadarcar
hafoxka	hahafoxka
zibjotno	zizibjotno
qulkad	ququlkad
myp	mymyp
siqkebda	sisiqkebda
heqo	heheqo
tyxxu	tytyxxu
xyzqol	xyxyzqol
nirujhic	ninirujhic
zusu	zuzusu
resvyxobupa	reresvyxobupa
vazcencex	vavazcencex
qatdubpuvy	qaqatdubpuvy
bomi	bobomi
paco	papaco
paqwo	papaqwo
qijam	qiqijam
weheq	weweheq
goltyn	gogoltyn
nyrmysa	nynyrmysa
wilox	wiwilox
zycxa	zyzycxa
dodisez	dododisez
ruwwyx	ruruwwyx
hacaj	hahacaj
wazumykipa	wawazumykipa
zysocoj	zyzysocoj
qimyc	qiqimyc
pyhkyv	pypyhkyv
cumez	cucumez
sugib	susugib
jutkidjokolcu	jujutkidjokolcu
qyrnetysloc	qyqyrnetysloc
kaq	kakaq
xuf	xuxuf
gercul	gegercul
vuz	vuvuz
miqyb	mimiqyb
xonku	xoxonku
xicos	xixicos
cavyncifve	cacavyncifve
qadut	qaqadut
capam	cacapam
cibhe	cicibhe
baqu	babaqu
zuniratna	zuzuniratna
gyxurolpyjpyl	gygyxurolpyjpyl
nynybcur	nynynybcur
pyf	pypyf
qoqanu	qoqoqanu
jocba	jojocba
fub	fufub
qeb	qeqeb
xycgofbypot	xyxycgofbypot
kivak	kikivak
puxfu	pupuxfu
nanjukrumuwok	nananjukrumuwok
sefqeg	sesefqeg
syvzyg	sysyvzyg
dely	dedely
habzym	hahabzym
guwycvov	guguwycvov
mip	mimip
xugdugune	xuxugdugune
peqyq	pepeqyq
dedam	dededam
nuhym	nunuhym
hugpykxut	huhugpykxut
rojaqa	rorojaqa
vytfokqu	vyvytfokqu
lev	lelev
rumub	rurumub
lyqqom	lylyqqom
vez	vevez
kemzisoc	kekemzisoc
wirocib	wiwirocib
vasky	vavasky
zomzy	zozomzy
jepsyplap	jejepsyplap
gorfyl	gogorfyl
pipqunbez	pipipqunbez
zoxwudis	zozoxwudis
zezuqexym	zezezuqexym
vevby	vevevby
sadoz	sasadoz
tuhedhebcemwu	tutuhedhebcemwu
muhipde	mumuhipde
kipid	kikipid
hyxsic	hyhyxsic
hiqcaxneqhimgy	hihiqcaxneqhimgy
zymusa	zyzymusa
givif	gigivif
hosudi	hohosudi
bovbi	bobovbi
ruxnyz	ruruxnyz
zarif	zazarif
hiquf	hihiquf
melvivaqahe	memelvivaqahe
sywcytkoqybva	sysywcytkoqybva
duj	duduj
rilpaqyvqi	ririlpaqyvqi
lawju	lalawju
pobjyjisaj	popobjyjisaj
syxnud	sysyxnud
taqo	tataqo
dipkev	didipkev
lawfi	lalawfi
ryqaf	ryryqaf
sici	sisici
rulkec	rurulkec
cuhsyhjy	cucuhsyhjy
hosloznib	hohosloznib
xirgis	xixirgis
linojdenyhy	lilinojdenyhy
wur	wuwur
guzgumvore	guguzgumvore
guq	guguq
logwyq	lologwyq
fidagwuqror	fifidagwuqror
pulaf	pupulaf
rudba	rurudba
rihehywtucib	ririhehywtucib
fybyzarfybtod	fyfybyzarfybtod
gispif	gigispif
ruhem	ruruhem
goxkusaxu	gogoxkusaxu
syx	sysyx
jepkado	jejepkado
ryzpyxmicry	ryryzpyxmicry
zowwun	zozowwun
nyb	nynyb
nolmaq	nonolmaq
mohzubipuza	momohzubipuza
tebsufyl	tetebsufyl
zilwypdyde	zizilwypdyde
xeji	xexeji
fynkobpocari	fyfynkobpocari
foxxudjom	fofoxxudjom
xaqeq	xaxaqeq
tiduhqan	titiduhqan
paro	paparo
semxy	sesemxy
rilqowalkali	ririlqowalkali
hunukkufber	huhunukkufber
vizmusrugim	vivizmusrugim
pysysysliwok	pypysysysliwok
kocap	kokocap
bo	bobo
tixpagys	titixpagys
tarmex	tatarmex
mefoz	memefoz
dapwo	dadapwo
nanoxwequziz	nananoxwequziz
cehekgomy	cecehekgomy
qehuj	qeqehuj
ryqwefqyzu	ryryqwefqyzu
cetune	cecetune
qynad	qyqynad
gedwec	gegedwec
gyqlol	gygyqlol
bufka	bubufka
hirxa	hihirxa
kybrij	kykybrij
hesefitvyle	hehesefitvyle
jophi	jojophi
nubykfoftanog	nunubykfoftanog
fenli	fefenli
togdop	totogdop
nikqymidmy	ninikqymidmy
qivippi	qiqivippi
nodor	nonodor
rysyk	ryrysyk
leh	leleh
qam	qaqam
xyto	xyxyto
qile	qiqile
zinwonjin	zizinwonjin
rub	rurub
juji	jujuji
deso	dedeso
lecfic	lelecfic
kakwowli	kakakwowli
mivhanbinokew	mimivhanbinokew
sid	sisid
fef	fefef
bihyb	bibihyb
ciwev	ciciwev
muvil	mumuvil
cycy	cycycy
jextujxo	jejextujxo
walolwyky	wawalolwyky
woxyshyhux	wowoxyshyhux
fo	fofo
qeh	qeqeh
hate	hahate
fugbechelav	fufugbechelav
hyqvyd	hyhyqvyd
femip	fefemip
bavvu	babavvu
zewcap	zezewcap
bufy	bubufy
qiw	qiqiw
dycif	dydycif
dywcyjkujlat	dydywcyjkujlat
jojyrwiq	jojojyrwiq
duzmezxorgiq	duduzmezxorgiq
pin	pipin
sylale	sysylale
xim	xixim
godredesukkip	gogodredesukkip
qimiq	qiqimiq
xyptaqecan	xyxyptaqecan
vyvyjwa	vyvyvyjwa
qowi	qoqowi
tarhup	tatarhup
nadifzy	nanadifzy
dujqeh	dudujqeh
xirky	xixirky
guqaq	guguqaq
todxi	totodxi
teqlo	teteqlo
tygxyxsyl	tytygxyxsyl
ryhenamlymwuc	ryryhenamlymwuc
wymcizjym	wywymcizjym
bompyh	bobompyh
geja	gegeja
cevqyngi	cecevqyngi
xywzyboh	xyxywzyboh
vehehzyl	vevehehzyl
poc	popoc
dez	dedez
pevbyngyzo	pepevbyngyzo
gawqi	gagawqi
tezehu	tetezehu
vewynejcy	vevewynejcy
jisdok	jijisdok
dajacy	dadajacy
cabdymce	cacabdymce
kiwfo	kikiwfo
dini	didini
lafyjar	lalafyjar
sataseh	sasataseh
cyzkukcuregba	cycyzkukcuregba
cexevi	cecexevi
xuq	xuxuq
fyredbe	fyfyredbe
me	meme
ruhsosej	ruruhsosej
wekynuvygde	wewekynuvygde
mefjimoq	memefjimoq
jicitiswa	jijicitiswa
madno	mamadno
nolvupypfysoh	nonolvupypfysoh
xocfu	xoxocfu
cuxuh	cucuxuh
dobwyfig	dodobwyfig
qobihri	qoqobihri
qig	qiqig
cudporoxuja	cucudporoxuja
nofixzic	nonofixzic
giha	gigiha
raspegwal	raraspegwal
syfwe	sysyfwe
pebit	pepebit
qurpedowjy	ququrpedowjy
cuxtew	cucuxtew
hely	hehely
jisop	jijisop
tihaw	titihaw
gevfe	gegevfe
jyr	jyjyr
zuli	zuzuli
joguzefzehyn	jojoguzefzehyn
towix	totowix
benijpazev	bebenijpazev
dot	dodot
zixguhpi	zizixguhpi
rul	rurul
rebzujej	rerebzujej
xegxy	xexegxy
kucqil	kukucqil
walgu	wawalgu
kulan	kukulan
rynaqig	ryrynaqig
lucgiqwy	lulucgiqwy
ri	riri
filhydhu	fifilhydhu
qixxazta	qiqixxazta
zezdeb	zezezdeb
jadok	jajadok
viqsag	viviqsag
xoxvitu	xoxoxvitu
wunov	wuwunov
rixomfem	ririxomfem
hejcoscukxa	hehejcoscukxa
howyqik	hohowyqik
humynow	huhumynow
fovovyd	fofovovyd
qojoq	qoqojoq
mixziwoj	mimixziwoj
rule	rurule
nujtybi	nunujtybi
vulbeqvoxuhbi	vuvulbeqvoxuhbi
konacpen	kokonacpen
lyzakaf	lylyzakaf
ram	raram
gewwijidqu	gegewwijidqu
xypcujikbog	xyxypcujikbog
syv	sysyv
bibxaj	bibibxaj
buqjex	bubuqjex
dijeb	didijeb
lucemvijper	lulucemvijper
judza	jujudza
wazmil	wawazmil
xarti	xaxarti
zuxpisimguva	zuzuxpisimguva
zegpugraqivwo	zezegpugraqivwo
zu	zuzu
puwilpu	pupuwilpu
myjfiz	mymyjfiz
kefgal	kekefgal
tilrel	titilrel
zuzo	zuzuzo
dagcu	dadagcu
coqaxsidriru	cocoqaxsidriru
vor	vovor
vikazot	vivikazot
wyngy	wywyngy
xusnevjaf	xuxusnevjaf
raxkewcilcodfon	raraxkewcilcodfon
virij	vivirij
bavcybun	babavcybun
dyp	dydyp
qekogxydsacyh	qeqekogxydsacyh
beveh	bebeveh
zuvaswybema	zuzuvaswybema
guktomo	guguktomo
katowqawovlyx	kakatowqawovlyx
cuqwip	cucuqwip
fegmi	fefegmi
xyvo	xyxyvo
hesosuvzu	hehesosuvzu
tozampervep	totozampervep
ciricu	ciciricu
lelitlivdav	lelelitlivdav
huvdefyciz	huhuvdefyciz
rovfax	rorovfax
wadgyzejusfol	wawadgyzejusfol
zyry	zyzyry
lujnyqadyqmok	lulujnyqadyqmok
nulkacalhad	nunulkacalhad
dijsobylug	didijsobylug
mugo	mumugo
goprim	gogoprim
fyxsoka	fyfyxsoka
vyntoqix	vyvyntoqix
bakokunu	babakokunu
fuwhyh	fufuwhyh
pudgubnipdaso	pupudgubnipdaso
zymneputwobe	zyzymneputwobe
kaknev	kakaknev
sozce	sosozce
guble	guguble
jyvmu	jyjyvmu
hidaqe	hihidaqe
tidyh	titidyh
widyvpyk	wiwidyvpyk
xoxisa	xoxoxisa
devxiskyjex	dedevxiskyjex
loryk	loloryk
pinodolagus	pipinodolagus
tyrwi	tytyrwi
mabo	mamabo
baz	babaz
syqfyg	sysyqfyg
zacqindiruzdel	zazacqindiruzdel
bivgawexe	bibivgawexe
lulsis	lululsis
timyr	titimyr
xiflizgomzafzik	xixiflizgomzafzik
baqal	babaqal
kapozujovko	kakapozujovko
nidsim	ninidsim
fanav	fafanav
porejarwugus	poporejarwugus
pyc	pypyc
lemhagybzazxoz	lelemhagybzazxoz
vafy	vavafy
hin	hihin
nuqfulsowzodiq	nunuqfulsowzodiq
pypemugsovju	pypypemugsovju
nudfohane	nunudfohane
qetpu	qeqetpu
bawahcos	babawahcos
fimgax	fifimgax
molzikak	momolzikak
lipgabaxu	lilipgabaxu
facnyhygemu	fafacnyhygemu
qifqefohi	qiqifqefohi
jire	jijire
getlozuwleg	gegetlozuwleg
ximatasqagum	xiximatasqagum
monfugbany	momonfugbany
lytyni	lylytyni
jagzobutnospyp	jajagzobutnospyp
kocmiveqeciw	kokocmiveqeciw
tor	totor
sylhi	sysylhi
lyta	lylyta
tydty	tytydty
lypkegok	lylypkegok
dopme	dodopme
mysap	mymysap
xudibatdub	xuxudibatdub
lacfu	lalacfu
ketoje	keketoje
landanwyhfoz	lalandanwyhfoz
cyn	cycyn
pulluzeh	pupulluzeh
liqmyd	liliqmyd
liga	liliga
dikcy	didikcy
naczajovkig	nanaczajovkig
tutex	tututex
sinmet	sisinmet
bivozikecvix	bibivozikecvix
bawcy	babawcy
vamokmabez	vavamokmabez
vepe	vevepe
vamo	vavamo
wubkeh	wuwubkeh
xoxkubky	xoxoxkubky
todynbazotak	totodynbazotak
vavgibih	vavavgibih
jaki	jajaki
wilyh	wiwilyh
ze	zeze
dywax	dydywax
dul	dudul
didvuvotimyz	dididvuvotimyz
wolwipa	wowolwipa
dolsyv	dodolsyv
byqxyhluhosbon	bybyqxyhluhosbon
qahypvosmiksi	qaqahypvosmiksi
mida	mimida
cuxil	cucuxil
nusqikdov	nunusqikdov
gyjij	gygyjij
jus	jujus
qabpyke	qaqabpyke
go	gogo
qeqqecep	qeqeqqecep
gyjogqi	gygyjogqi
ryd	ryryd
lyxcesah	lylyxcesah
cud	cucud
fetnynetfac	fefetnynetfac
pita	pipita
ler	leler
bajfuf	babajfuf
xotani	xoxotani
voktuszuk	vovoktuszuk
tuktod	tutuktod
jibka	jijibka
bofa	bobofa
koqhym	kokoqhym
litwe	lilitwe
gypap	gygypap
hiwcek	hihiwcek
hiq	hihiq
keduhon	kekeduhon
xullun	xuxullun
livkuwpa	lilivkuwpa
lixmyn	lilixmyn
fyvaxuhiv	fyfyvaxuhiv
pilag	pipilag
quljelkumirro	ququljelkumirro
sivki	sisivki
buwym	bubuwym
wykes	wywykes
xuka	xuxuka
gopah	gogopah
turodmijedve	tuturodmijedve
betojzab	bebetojzab
tacop	tatacop
dusahdi	dudusahdi
raqurhexlopmu	raraqurhexlopmu
zymwuwzekxol	zyzymwuwzekxol
cyne	cycyne
lugdo	lulugdo
tyt	tytyt
malpybok	mamalpybok
gujykxem	gugujykxem
zuho	zuzuho
wesywozqozwob	wewesywozqozwob
nivet	ninivet
xubdu	xuxubdu
sak	sasak
wyb	wywyb
rufe	rurufe
hatyq	hahatyq
syxny	sysyxny
libecxebacud	lilibecxebacud
ruhu	ruruhu
tezixavbibre	tetezixavbibre
vepet	vevepet
bizhyz	bibizhyz
rujazew	rurujazew
kyfi	kykyfi
wecah	wewecah
kelra	kekelra
paw	papaw
voq	vovoq
bupazyzgytgi	bubupazyzgytgi
xyclys	xyxyclys
qinydve	qiqinydve
vos	vovos
kezodos	kekezodos
xadyzyv	xaxadyzyv
jakicdilebqyq	jajakicdilebqyq
duju	duduju
gaso	gagaso
taskun	tataskun
fisy	fifisy
xov	xoxov
wyqzykqaqul	wywyqzykqaqul
wihijcanbo	wiwihijcanbo
lodga	lolodga
wecy	wewecy
hiqdubdujsoqo	hihiqdubdujsoqo
pigxuzeqpa	pipigxuzeqpa
waghac	wawaghac
zamuwexbovew	zazamuwexbovew
bosqazvuj	bobosqazvuj
kusvo	kukusvo
pyv	pypyv
jughed	jujughed
cenamiz	cecenamiz
gopoj	gogopoj
qeri	qeqeri
hezpy	hehezpy
tyvze	tytyvze
cixbi	cicixbi
cozkyh	cocozkyh
sothe	sosothe
zyty	zyzyty
nesumpyqe	nenesumpyqe
mykilebcuz	mymykilebcuz
dezynnylpoltet	dedezynnylpoltet
zavyhjon	zazavyhjon
lylfinli	lylylfinli
magi	mamagi
haxo	hahaxo
jinym	jijinym
keruvho	kekeruvho
zyt	zyzyt
mocy	momocy
metopowti	memetopowti
tuwej	tutuwej
sebeb	sesebeb
zosycgezetse	zozosycgezetse
caldo	cacaldo
nychecuqfe	nynychecuqfe
liflihgo	liliflihgo
ducce	duducce
pozdum	popozdum
bapmiq	babapmiq
zytys	zyzytys
wuzy	wuwuzy
jihyh	jijihyh
cihjo	cicihjo
sesugru	sesesugru
lyn	lylyn
qagsaw	qaqagsaw
supu	susupu
tev	tetev
wykeboqewyl	wywykeboqewyl
nuvqy	nunuvqy
fojsugvuqefa	fofojsugvuqefa
rakbyfaw	rarakbyfaw
tycqofpy	tytycqofpy
zynzafy	zyzynzafy
piry	pipiry
mesvinpyfo	memesvinpyfo
vituk	vivituk
wefitlup	wewefitlup
jetutliplemet	jejetutliplemet
kum	kukum
buwutquqeqyn	bubuwutquqeqyn
tazeh	tatazeh
zekificam	zezekificam
heneb	heheneb
met	memet
tukpak	tutukpak
muzle	mumuzle
zoqga	zozoqga
nucxuran	nunucxuran
curte	cucurte
mongiv	momongiv
foqo	fofoqo
kogtarnumyvwof	kokogtarnumyvwof
cyhaz	cycyhaz
lyrvurabky	lylyrvurabky
daj	dadaj
jahsu	jajahsu
sipus	sisipus
lurqozqa	lulurqozqa
vojaxre	vovojaxre
guly	guguly
cahly	cacahly
ruzizisbo	ruruzizisbo
jixde	jijixde
jib	jijib
mabolkuslabyb	mamabolkuslabyb
mefyzy	memefyzy
tiju	titiju
xocsybliv	xoxocsybliv
fyjypap	fyfyjypap
woha	wowoha
tyxbuj	tytyxbuj
jat	jajat
takitywas	tatakitywas
xiw	xixiw
kowic	kokowic
gyve	gygyve
dax	dadax
waffow	wawaffow
xewa	xexewa
befa	bebefa
vu	vuvu
pigbi	pipigbi
razeg	rarazeg
jane	jajane
tolo	totolo
sygjotpyjzodsok	sysygjotpyjzodsok
nyjy	nynyjy
pofuq	popofuq
xaxhyhu	xaxaxhyhu
nabef	nanabef
sujpaneforyq	susujpaneforyq
pywepdovy	pypywepdovy
kuluhbyvxi	kukuluhbyvxi
qybzy	qyqybzy
bazgol	babazgol
racwapqa	raracwapqa
tevom	tetevom
muruxtode	mumuruxtode
wosky	wowosky
dyqmyd	dydyqmyd
zobjotonsacrep	zozobjotonsacrep
vifihtyz	vivifihtyz
gyky	gygyky
zikib	zizikib
pigappitxo	pipigappitxo
fulesdij	fufulesdij
guprubxy	guguprubxy
jixrypnyvuhhyr	jijixrypnyvuhhyr
cibidypxeto	cicibidypxeto
balen	babalen
razfotvamurdy	rarazfotvamurdy
wirawiri	wiwirawiri
jalavema	jajalavema
kekatin	kekekatin
jaq	jajaq
fugre	fufugre
faxtohnig	fafaxtohnig
suz	susuz
zezryte	zezezryte
cotyx	cocotyx
kolebpog	kokolebpog
xamas	xaxamas
teqi	teteqi
kygre	kykygre
wattucebkutas	wawattucebkutas
qumrikra	ququmrikra
qyrutfuzyv	qyqyrutfuzyv
nobuldyn	nonobuldyn
cybrewzozuckuc	cycybrewzozuckuc
rinyh	ririnyh
nowbaxen	nonowbaxen
xoljire	xoxoljire
tundu	tutundu
kocaxakryx	kokocaxakryx
zaho	zazaho
sobhy	sosobhy
kufvy	kukufvy
ximxaw	xiximxaw
lobyf	lolobyf
giz	gigiz
hu	huhu
wepmedac	wewepmedac
mirace	mimirace
fodxewo	fofodxewo
nojop	nonojop
gukaj	gugukaj
wyfifjif	wywyfifjif
qez	qeqez
sodix	sosodix
qusyrogogi	ququsyrogogi
wecenyd	wewecenyd
walwuw	wawalwuw
rejakqibba	rerejakqibba
jotsyj	jojotsyj
xybfoloshyr	xyxybfoloshyr
ceju	ceceju
fasik	fafasik
jakwi	jajakwi
hogolaf	hohogolaf
nurejpoxy	nunurejpoxy
benxidzytit	bebenxidzytit
budberakri	bubudberakri
xyhruxijadmo	xyxyhruxijadmo
luhyvofezy	luluhyvofezy
goxew	gogoxew
nigy	ninigy
dala	dadala
wak	wawak
wyvitki	wywyvitki
sugsomnygby	susugsomnygby
hani	hahani
giqpofnes	gigiqpofnes
bupotyhudbup	bubupotyhudbup
vi	vivi
leslatpegnip	leleslatpegnip
kacoqujwucjo	kakacoqujwucjo
boqys	boboqys
wicax	wiwicax
duhre	duduhre
jurzoqno	jujurzoqno
rovyqjo	rorovyqjo
fabge	fafabge
xigfon	xixigfon
qoha	qoqoha
bop	bobop
lybmacejyz	lylybmacejyz
xexo	xexexo
kimum	kikimum
letdexizeqla	leletdexizeqla
xuwfa	xuxuwfa
hako	hahako
zovdyqevzicnub	zozovdyqevzicnub
wize	wiwize
kebut	kekebut
raspikof	raraspikof
lywsirqup	lylywsirqup
muhib	mumuhib
lycdybciv	lylycdybciv
meqny	memeqny
tukby	tutukby
cem	cecem
mojza	momojza
gyjahyzorny	gygyjahyzorny
ramfa	raramfa
ked	keked
zyxnadpoj	zyzyxnadpoj
wucucirgo	wuwucucirgo
takawax	tatakawax
zonqyzi	zozonqyzi
nybjyd	nynybjyd
bambi	babambi
gyksesteb	gygyksesteb
lekhi	lelekhi
dugpyw	dudugpyw
gos	gogos
juwqut	jujuwqut
juzquckyx	jujuzquckyx
pemogot	pepemogot
qorpoh	qoqorpoh
ciz	ciciz
mokajih	momokajih
komex	kokomex
zekonip	zezekonip
putu	puputu
dahi	dadahi
rymaf	ryrymaf
rinucaxiq	ririnucaxiq
pithyw	pipithyw
qixiwiwmyb	qiqixiwiwmyb
sypdozzy	sysypdozzy
qumnipybadaq	ququmnipybadaq
qydqehretny	qyqydqehretny
lyzfe	lylyzfe
viclob	viviclob
faw	fafaw
nuhkewu	nunuhkewu
goxby	gogoxby
ded	deded
rynicqek	ryrynicqek
sehiveb	sesehiveb
suqemizysnir	susuqemizysnir
cupdatovito	cucupdatovito
zysdawixdunpov	zyzysdawixdunpov
pobxuxo	popobxuxo
cijqu	cicijqu
ginxus	giginxus
fup	fufup
fuqetah	fufuqetah
zowgot	zozowgot
guki	guguki
cydcy	cycydcy
bunba	bubunba
nagsydlaxukju	nanagsydlaxukju
xaktoqi	xaxaktoqi
zuf	zuzuf
fycomlobmyrpyq	fyfycomlobmyrpyq
hysil	hyhysil
lydidokzit	lylydidokzit
myxbitfo	mymyxbitfo
giddaw	gigiddaw
lyv	lylyv
gurvyw	gugurvyw
qiqcitem	qiqiqcitem
xilahe	xixilahe
jejmuhmi	jejejmuhmi
gamo	gagamo
nawi	nanawi
govmagacurhyl	gogovmagacurhyl
jalyl	jajalyl
fuf	fufuf
naslix	nanaslix
pufo	pupufo
gefeqab	gegefeqab
lor	lolor
qyvwulyccy	qyqyvwulyccy
cer	cecer
cusbudqeb	cucusbudqeb
dixjiw	didixjiw
ricjijytigdi	riricjijytigdi
nuvovrir	nunuvovrir
neviqe	neneviqe
qahdilytyc	qaqahdilytyc
bycbojywesi	bybycbojywesi
zofuda	zozofuda
ruhir	ruruhir
dybbogap	dydybbogap
nynqyfguspil	nynynqyfguspil
mabudiv	mamabudiv
ryvgegoz	ryryvgegoz
duvqymho	duduvqymho
wysno	wywysno
seqziz	seseqziz
tuhga	tutuhga
sazfy	sasazfy
syh	sysyh
dil	didil
dudnohe	dududnohe
votixe	vovotixe
kiw	kikiw
nasexud	nanasexud
xudpiw	xuxudpiw
qumyw	ququmyw
galaf	gagalaf
wujiskadbirzu	wuwujiskadbirzu
baw	babaw
zuswetozaf	zuzuswetozaf
cilysuwsysmy	cicilysuwsysmy
lixrujaq	lilixrujaq
jepgutmy	jejepgutmy
diqyvqekovgy	didiqyvqekovgy
benninve	bebenninve
jywakos	jyjywakos
myzo	mymyzo
jaqof	jajaqof
tupujgeka	tutupujgeka
bugef	bubugef
donjizfite	dodonjizfite
pago	papago
guhyb	guguhyb
jaraw	jajaraw
noqni	nonoqni
myxjy	mymyxjy
mukruwked	mumukruwked
qyhqa	qyqyhqa
xylbo	xyxylbo
xekfu	xexekfu
lasbinfyhke	lalasbinfyhke
xyf	xyxyf
wutet	wuwutet
povtil	popovtil
borul	boborul
nonuzodhez	nononuzodhez
zapma	zazapma
xux	xuxux
zixbopem	zizixbopem
nijuf	ninijuf
myjxof	mymyjxof
se	sese
vyrotbil	vyvyrotbil
geca	gegeca
komujfi	kokomujfi
hoska	hohoska
xywmypuf	xyxywmypuf
sapqemeq	sasapqemeq
goq	gogoq
liffi	liliffi
rapoj	rarapoj
mugom	mumugom
makzob	mamakzob
camvov	cacamvov
xuv	xuxuv
bisda	bibisda
ly	lyly
ruwvobyqvapum	ruruwvobyqvapum
wexoq	wewexoq
remuky	reremuky
hadazqur	hahadazqur
maxro	mamaxro
bajxyg	babajxyg
fofyqse	fofofyqse
xejer	xexejer
zasoc	zazasoc
ponapbod	poponapbod
tabgafib	tatabgafib
kygrec	kykygrec
guge	guguge
caqwatalqyhpef	cacaqwatalqyhpef
pune	pupune
bipegymlolu	bibipegymlolu
lazhof	lalazhof
jolul	jojolul
duw	duduw
qoczi	qoqoczi
rupwi	rurupwi
togfebywgoty	totogfebywgoty
diqcyr	didiqcyr
xemmo	xexemmo
coszimuci	cocoszimuci
mahfu	mamahfu
dexyl	dedexyl
giv	gigiv
nofmyxob	nonofmyxob
setarywrypri	sesetarywrypri
ciffyzagtyn	ciciffyzagtyn
mabdocedvu	mamabdocedvu
qinweg	qiqinweg
gak	gagak
gabdu	gagabdu
synud	sysynud
numwa	nunumwa
nygeqleba	nynygeqleba
judki	jujudki
wimpexelyrab	wiwimpexelyrab
jywusbor	jyjywusbor
folafhaqivyj	fofolafhaqivyj
nidobdy	ninidobdy
wapuz	wawapuz
gici	gigici
pidcoxok	pipidcoxok
zelfy	zezelfy
tan	tatan
mandichozac	mamandichozac
musbahhob	mumusbahhob
lynutbak	lylynutbak
jakoganuk	jajakoganuk
waffoq	wawaffoq
cun	cucun
kaxag	kakaxag
haza	hahaza
tefluwyhrawi	tetefluwyhrawi
zykytwymi	zyzykytwymi
sopdo	sosopdo
wudqyh	wuwudqyh
siqbany	sisiqbany
buvju	bubuvju
fywot	fyfywot
hutiwkiqorqa	huhutiwkiqorqa
waphujesxuwto	wawaphujesxuwto
pykezoh	pypykezoh
miga	mimiga
jifur	jijifur
paxsina	papaxsina
noje	nonoje
niweho	niniweho
juf	jujuf
qirazdam	qiqirazdam
qygcoqvipatmi	qyqygcoqvipatmi
fisa	fifisa
bytpyl	bybytpyl
qarucy	qaqarucy
lixruzih	lilixruzih
pijocig	pipijocig
mul	mumul
bikel	bibikel
vuw	vuvuw
nih	ninih
ninadyzgec	nininadyzgec
lumtazralade	lulumtazralade
wilqomtuj	wiwilqomtuj
vinon	vivinon
bipib	bibipib
rabcugja	rarabcugja
lonudpyv	lolonudpyv
tyhoz	tytyhoz
mavuhxo	mamavuhxo
ry	ryry
civpigylubov	cicivpigylubov
myzbo	mymyzbo
xamxe	xaxamxe
sunkyjkog	susunkyjkog
lamdo	lalamdo
jinbomditvyl	jijinbomditvyl
dux	dudux
wony	wowony
vuhobme	vuvuhobme
mibqefuz	mimibqefuz
jaxpoclihcyw	jajaxpoclihcyw
tejuhuk	tetejuhuk
weslulij	weweslulij
murdewwecaw	mumurdewwecaw
wortegbu	wowortegbu
bilo	bibilo
xyhibjiwsij	xyxyhibjiwsij
redyvvywavfi	reredyvvywavfi
dof	dodof
vefirnonqidgeq	vevefirnonqidgeq
nimfikdyvdidul	ninimfikdyvdidul
sokot	sosokot
sacezor	sasacezor
racbes	raracbes
niqex	niniqex
luvexitfyji	luluvexitfyji
fihbaq	fifihbaq
zelpuf	zezelpuf
wej	wewej
laki	lalaki
reru	rereru
wotulcy	wowotulcy
quzew	ququzew
rimqihizmesvo	ririmqihizmesvo
tyce	tytyce
zornesti	zozornesti
hecujsagvektag	hehecujsagvektag
zuro	zuzuro
sezzydquvxinqok	sesezzydquvxinqok
xyzet	xyxyzet
ziptycqemo	ziziptycqemo
loglyt	lologlyt
sithavmy	sisithavmy
fuwsysyletif	fufuwsysyletif
wikol	wiwikol
somnim	sosomnim
rys	ryrys
sixid	sisixid
memri	mememri
goruwfyx	gogoruwfyx
diczutjijzobjyk	didiczutjijzobjyk
muq	mumuq
taqu	tataqu
sosdapculjij	sososdapculjij
dalaqcar	dadalaqcar
bek	bebek
narcym	nanarcym
xatyhcymsox	xaxatyhcymsox
ragbufu	raragbufu
qodgun	qoqodgun
mapkot	mamapkot
xibu	xixibu
jygju	jyjygju
loqfo	loloqfo
foca	fofoca
hicob	hihicob
jiko	jijiko
zacwig	zazacwig
qyfbuzojuc	qyqyfbuzojuc
meqo	memeqo
qyjfejer	qyqyjfejer
wum	wuwum
wevsyt	wewevsyt
koqgaz	kokoqgaz
how	hohow
myforqoci	mymyforqoci
pubpava	pupubpava
rylpu	ryrylpu
pepzu	pepepzu
tow	totow
josymry	jojosymry
soxotmaletsul	sosoxotmaletsul
kensubkaq	kekensubkaq
kuzqofefyx	kukuzqofefyx
lenit	lelenit
jutqag	jujutqag
bymbo	bybymbo
quzoh	ququzoh
del	dedel
xuctorak	xuxuctorak
bobe	bobobe
veb	veveb
fympe	fyfympe
qah	qaqah
ve	veve
fimyf	fifimyf
nesojo	nenesojo
qobyrekud	qoqobyrekud
sifbydowcofxa	sisifbydowcofxa
pax	papax
cibox	cicibox
rehti	rerehti
woxbepuwma	wowoxbepuwma
li	lili
sugu	susugu
ryqtoz	ryryqtoz
bixyfugohyp	bibixyfugohyp
nersu	nenersu
gicor	gigicor
hacyfhamfy	hahacyfhamfy
zipobcew	zizipobcew
luragjuqyxe	luluragjuqyxe
xyki	xyxyki
tegbifir	tetegbifir
galu	gagalu
nevsyza	nenevsyza
howninvin	hohowninvin
bihruziqimpyl	bibihruziqimpyl
xufesek	xuxufesek
fytonuf	fyfytonuf
dyqavky	dydyqavky
joxi	jojoxi
jumboqbyq	jujumboqbyq
cehbe	cecehbe
soxfanha	sosoxfanha
jabagiqgem	jajabagiqgem
deg	dedeg
xege	xexege
campux	cacampux
vengi	vevengi
mocugac	momocugac
vuda	vuvuda
zacviqi	zazacviqi
fijalcah	fifijalcah
lefso	lelefso
retqocorywtoj	reretqocorywtoj
bute	bubute
doson	dodoson
gitqizomy	gigitqizomy
siv	sisiv
tizu	titizu
bacexcu	babacexcu
zopiqhow	zozopiqhow
syzexaslor	sysyzexaslor
gaw	gagaw
ratug	raratug
gidos	gigidos
maqo	mamaqo
bofbyzdud	bobofbyzdud
wu	wuwu
cykrat	cycykrat
lycnobve	lylycnobve
zejokok	zezejokok
zyvwa	zyzyvwa
putco	puputco
zyx	zyzyx
qutaklew	ququtaklew
rilhislytso	ririlhislytso
lomno	lolomno
zyj	zyzyj
kuvveh	kukuvveh
cehcihava	cecehcihava
xevjam	xexevjam
jybtiv	jyjybtiv
fuwa	fufuwa
hogonjahux	hohogonjahux
zojydacluwgij	zozojydacluwgij
for	fofor
kaktu	kakaktu
sujfa	susujfa
qis	qiqis
fexhi	fefexhi
lyxbihbejo	lylyxbihbejo
juscovojdowa	jujuscovojdowa
puhu	pupuhu
heffoqerymuq	heheffoqerymuq
sykzy	sysykzy
holpyd	hoholpyd
xipuvlogmodfy	xixipuvlogmodfy
punuk	pupunuk
raloczewby	raraloczewby
cuqogmukges	cucuqogmukges
jugaf	jujugaf
wifrisce	wiwifrisce
rubyrac	rurubyrac
wij	wiwij
viqot	viviqot
junwij	jujunwij
deqno	dedeqno
rilhotyjyfym	ririlhotyjyfym
fehyn	fefehyn
sufu	susufu
hohimupwino	hohohimupwino
mud	mumud
mivlyt	mimivlyt
qek	qeqek
qyxveqoxxo	qyqyxveqoxxo
bagipsil	babagipsil
gubcic	gugubcic
lebes	lelebes
lera	lelera
jisa	jijisa
lyqov	lylyqov
tylducegiqpiz	tytylducegiqpiz
qilin	qiqilin
vukvu	vuvukvu
qeso	qeqeso
lahmyra	lalahmyra
qomu	qoqomu
jep	jejep
nunvaqo	nununvaqo
garamda	gagaramda
nevnomvorbaq	nenevnomvorbaq
toxiroh	totoxiroh
box	bobox
nusemzomido	nunusemzomido
zixbek	zizixbek
lymta	lylymta
xujel	xuxujel
sogiqdexadzyf	sosogiqdexadzyf
pyxajfa	pypyxajfa
lycvydo	lylycvydo
gogpu	gogogpu
sotzu	sosotzu
dezcom	dedezcom
xywanek	xyxywanek
qevagob	qeqevagob
xegkokokvug	xexegkokokvug
raljeqoses	raraljeqoses
cyvuq	cycyvuq
dyb	dydyb
guzsof	guguzsof
put	puput
bosno	bobosno
rybgaqedosboj	ryrybgaqedosboj
cis	cicis
cy	cycy
tyhbiwmexadmax	tytyhbiwmexadmax
hiqhom	hihiqhom
nabce	nanabce
myw	mymyw
xipbe	xixipbe
teknapzez	teteknapzez
luczanydven	luluczanydven
gypew	gygypew
nuv	nunuv
rowryqyt	rorowryqyt
venly	vevenly
vaga	vavaga
ruk	ruruk
juby	jujuby
pevav	pepevav
ziwiwo	ziziwiwo
koqkycsiggo	kokoqkycsiggo
kexfa	kekexfa
lyme	lylyme
rencaf	rerencaf
vel	vevel
qywibugkur	qyqywibugkur
kawfyha	kakawfyha
durovahuwqe	dudurovahuwqe
joceryw	jojoceryw
veret	veveret
vemdad	vevemdad
dubo	dudubo
foxjo	fofoxjo
cifguh	cicifguh
sar	sasar
katqe	kakatqe
conam	coconam
kyxbeqi	kykyxbeqi
lusfukywsydar	lulusfukywsydar
fucy	fufucy
pudug	pupudug
punwuzjiruryv	pupunwuzjiruryv
mukelifxa	mumukelifxa
nurid	nunurid
vajzevma	vavajzevma
tamumvu	tatamumvu
husu	huhusu
zunvovnab	zuzunvovnab
jiq	jijiq
woqzixogyny	wowoqzixogyny
nyropodyveg	nynyropodyveg
sagpyt	sasagpyt
jetzusqirhunxe	jejetzusqirhunxe
kehryv	kekehryv
patyf	papatyf
pacrezixihob	papacrezixihob
vima	vivima
picwy	pipicwy
cawi	cacawi
jigwuw	jijigwuw
zirewjem	zizirewjem
cehy	cecehy
cappesig	cacappesig
sosoka	sososoka
wah	wawah
syro	sysyro
wykygoro	wywykygoro
zycpiqe	zyzycpiqe
viqam	viviqam
rixki	ririxki
zikigtyg	zizikigtyg
pum	pupum
nonu	nononu
lytpuhdomi	lylytpuhdomi
qirtyg	qiqirtyg
rynar	ryrynar
nifceky	ninifceky
tyz	tytyz
hil	hihil
rerbokca	rererbokca
kejzo	kekejzo
nafod	nanafod
jyqazmotupuh	jyjyqazmotupuh
coxdinzuc	cocoxdinzuc
gimuzet	gigimuzet
vujwowhexakzef	vuvujwowhexakzef
natocanjy	nanatocanjy
fijy	fifijy
womepra	wowomepra
lytizlys	lylytizlys
cogzi	cocogzi
jixe	jijixe
qexyf	qeqexyf
qyfum	qyqyfum
jesarko	jejesarko
gozivqij	gogozivqij
pif	pipif
puzejbaz	pupuzejbaz
myquq	mymyquq
jyqa	jyjyqa
dadraz	dadadraz
panaqmap	papanaqmap
bogza	bobogza
hysac	hyhysac
dorzar	dodorzar
dypi	dydypi
puzy	pupuzy
bixyv	bibixyv
jakbef	jajakbef
fopdatoqpavli	fofopdatoqpavli
luwges	luluwges
wovkilyw	wowovkilyw
vehzo	vevehzo
tujqy	tutujqy
vin	vivin
ruda	ruruda
qadi	qaqadi
kahzupo	kakahzupo
vuqyxivfu	vuvuqyxivfu
kufojon	kukufojon
zoszehxukqig	zozoszehxukqig
xucyptovnivep	xuxucyptovnivep
dosget	dodosget
posem	poposem
nygo	nynygo
qyhguhaj	qyqyhguhaj
kagosucachad	kakagosucachad
wimyvac	wiwimyvac
cypdil	cycypdil
xohypy	xoxohypy
lagbuxjygit	lalagbuxjygit
nyco	nynyco
fevytzi	fefevytzi
balpa	babalpa
cupu	cucupu
qunoqyj	ququnoqyj
sejlystoh	sesejlystoh
zybex	zyzybex
bufhelfu	bubufhelfu
bagcalsuv	babagcalsuv
ryfdertylij	ryryfdertylij
cyjpex	cycyjpex
tym	tytym
jurlibci	jujurlibci
cozzugac	cocozzugac
byvfajoj	bybyvfajoj
wilweq	wiwilweq
jygpov	jyjygpov
gid	gigid
tyczi	tytyczi
samu	sasamu
ter	teter
tosxy	totosxy
ximtin	xiximtin
falekdygxy	fafalekdygxy
nuzuwsida	nunuzuwsida
xamy	xaxamy
duc	duduc
pigera	pipigera
but	bubut
jihpu	jijihpu
haja	hahaja
higo	hihigo
qosry	qoqosry
xyjpysupe	xyxyjpysupe
codyh	cocodyh
waxzu	wawaxzu
quvozuvni	ququvozuvni
das	dadas
nixhemu	ninixhemu
fodtaxa	fofodtaxa
wyq	wywyq
zepron	zezepron
sygoddyqatyb	sysygoddyqatyb
qeqetuk	qeqeqetuk
nufyvhivixij	nunufyvhivixij
xyxy	xyxyxy
nor	nonor
guwpyrnuwe	guguwpyrnuwe
myfdanjuk	mymyfdanjuk
xet	xexet
tuw	tutuw
puqyrkip	pupuqyrkip
wapmecregcuqo	wawapmecregcuqo
luvgohyw	luluvgohyw
pujcubazhom	pupujcubazhom
gefagezyv	gegefagezyv
dobur	dodobur
xamule	xaxamule
qymexpap	qyqymexpap
tecifxowuge	tetecifxowuge
hajawla	hahajawla
japwibi	jajapwibi
dafys	dadafys
jydgewezoq	jyjydgewezoq
byljat	bybyljat
siqforxowzynco	sisiqforxowzynco
zodxi	zozodxi
tuki	tutuki
kawpi	kakawpi
wygev	wywygev
qasqiqup	qaqasqiqup
vyhra	vyvyhra
wumgu	wuwumgu
reg	rereg
nokolyj	nonokolyj
xuqderzuq	xuxuqderzuq
wynesi	wywynesi
mosnu	momosnu
dajof	dadajof
qehqicyte	qeqehqicyte
hedwew	hehedwew
xoqydokergyk	xoxoqydokergyk
gesju	gegesju
retny	reretny
pivpihojo	pipivpihojo
jimgy	jijimgy
wo	wowo
jygu	jyjygu
sorywfa	sosorywfa
lefzu	lelefzu
japnuxy	jajapnuxy
zeny	zezeny
gupka	gugupka
johe	jojohe
qoho	qoqoho
dafacpyx	dadafacpyx
fyhyj	fyfyhyj
wufu	wuwufu
lury	lulury
wop	wowop
razemapras	rarazemapras
vewuxo	vevewuxo
wifa	wiwifa
gujiscebcas	gugujiscebcas
kefury	kekefury
puti	puputi
rovuj	rorovuj
kucxu	kukucxu
giwuxqery	gigiwuxqery
synjygew	sysynjygew
quhorga	ququhorga
qucux	ququcux
gamuh	gagamuh
nyktagadsi	nynyktagadsi
huzzeszib	huhuzzeszib
zivij	zizivij
wadhe	wawadhe
xetrotsu	xexetrotsu
noq	nonoq
borofa	boborofa
nyzyjuqa	nynyzyjuqa
cemalvu	cecemalvu
hyltyc	hyhyltyc
kydaqwo	kykydaqwo
vuqy	vuvuqy
nesuksenyxyv	nenesuksenyxyv
fixxe	fifixxe
kotsyb	kokotsyb
pat	papat
gef	gegef
hujetmobtafmeb	huhujetmobtafmeb
tocho	totocho
pukamelyt	pupukamelyt
codjylaz	cocodjylaz
bagpi	babagpi
sekyl	sesekyl
lelxav	lelelxav
zakoc	zazakoc
jesiw	jejesiw
ryrysozi	ryryrysozi
tyjnej	tytyjnej
sib	sisib
zij	zizij
basci	babasci
pocivkec	popocivkec
zoh	zozoh
gyjak	gygyjak
wiwuv	wiwiwuv
dusiz	dudusiz
hanrujjan	hahanrujjan
wyfzifbapive	wywyfzifbapive
qinzip	qiqinzip
gamqij	gagamqij
nazil	nanazil
togso	totogso
narewhipmax	nanarewhipmax
domxyg	dodomxyg
gujvutyc	gugujvutyc
haty	hahaty
xeto	xexeto
midy	mimidy
sut	susut
fek	fefek
xyhgod	xyxyhgod
rogy	rorogy
newywnujylu	nenewywnujylu
pitmyt	pipitmyt
qycquwusugwad	qyqycquwusugwad
wajlo	wawajlo
diwgaq	didiwgaq
daxmi	dadaxmi
fypeb	fyfypeb
vev	vevev
wuridje	wuwuridje
xupi	xuxupi
jugryk	jujugryk
sevky	sesevky
diqjeh	didiqjeh
niwyxdiqcolgyb	niniwyxdiqcolgyb
rajulon	rarajulon
cawfaj	cacawfaj
zyfatfam	zyzyfatfam
zybicygvi	zyzybicygvi
gebkycodofo	gegebkycodofo
xuphoq	xuxuphoq
nutkyle	nunutkyle
qedxix	qeqedxix
makmoha	mamakmoha
keviv	kekeviv
kavreve	kakavreve
votyl	vovotyl
bymsik	bybymsik
gibdarhiqbaxi	gigibdarhiqbaxi
wewqoz	wewewqoz
narjiba	nanarjiba
gyly	gygyly
rujy	rurujy
qubyx	ququbyx
sek	sesek
xifison	xixifison
rajjagyzginun	rarajjagyzginun
xorxy	xoxorxy
temyrvuf	tetemyrvuf
gytgecehy	gygytgecehy
sycbex	sysycbex
renozjubo	rerenozjubo
qojy	qoqojy
hav	hahav
nyjyx	nynyjyx
jihukikryg	jijihukikryg
xyd	xyxyd
hulefqy	huhulefqy
wypyksedjyhen	wywypyksedjyhen
qyca	qyqyca
vondefa	vovondefa
tutuxuk	tututuxuk
valkobvewu	vavalkobvewu
rofa	rorofa
keckoli	kekeckoli
gofci	gogofci
hiluncegef	hihiluncegef
jytka	jyjytka
rupycap	rurupycap
dyla	dydyla
wenil	wewenil
tuvy	tutuvy
cawsycuntenu	cacawsycuntenu
hoxpyqubry	hohoxpyqubry
net	nenet
lywfij	lylywfij
deb	dedeb
kipewzih	kikipewzih
dadeh	dadadeh
sywrug	sysywrug
quh	ququh
sowxid	sosowxid
pixenubasic	pipixenubasic
jupcyzmiwpef	jujupcyzmiwpef
honsivqerxu	hohonsivqerxu
nibocuj	ninibocuj
zemliret	zezemliret
ninfevrok	nininfevrok
covugiparly	cocovugiparly
nexjy	nenexjy
lelroq	lelelroq
faj	fafaj
zuwbyxfycynu	zuzuwbyxfycynu
giwoc	gigiwoc
bovtylitzoq	bobovtylitzoq
pusob	pupusob
bumta	bubumta
mygzikquzyjew	mymygzikquzyjew
jefogomafa	jejefogomafa
dumygy	dudumygy
vykcamafwagnoc	vyvykcamafwagnoc
sotuta	sosotuta
lagure	lalagure
nys	nynys
nuluwfezmyfzu	nunuluwfezmyfzu
xebuxis	xexebuxis
reqe	rereqe
zohgiko	zozohgiko
monde	momonde
bytoxxy	bybytoxxy
fin	fifin
remxy	reremxy
kiqulur	kikiqulur
moduhfyluvty	momoduhfyluvty
heti	heheti
wozike	wowozike
zirrahbekyxma	zizirrahbekyxma
hynnax	hyhynnax
selegifbubze	seselegifbubze
giqyqqexbabjor	gigiqyqqexbabjor
muqjesqyfom	mumuqjesqyfom
huxkuvif	huhuxkuvif
huhwar	huhuhwar
rezif	rerezif
ditdo	diditdo
mimuscaw	mimimuscaw
qajpicinuty	qaqajpicinuty
kew	kekew
tirzo	titirzo
muznaryk	mumuznaryk
woczurmupzoc	wowoczurmupzoc
pibhocbataxlu	pipibhocbataxlu
vec	vevec
suhuk	susuhuk
xiwekxoj	xixiwekxoj
wyz	wywyz
surha	susurha
nitymzufpilzyz	ninitymzufpilzyz
fuco	fufuco
sahifbeh	sasahifbeh
kaxi	kakaxi
kaza	kakaza
xenrudoz	xexenrudoz
welcagip	wewelcagip
gyva	gygyva
zeqazakqud	zezeqazakqud
jerfa	jejerfa
dovukkori	dodovukkori
zuruj	zuzuruj
mor	momor
kaduju	kakaduju
dav	dadav
bada	babada
fyn	fyfyn
cyqivlic	cycyqivlic
piqfivog	pipiqfivog
bih	bibih
vorbirgen	vovorbirgen
kyqzo	kykyqzo
gej	gegej
xujqagu	xuxujqagu
xolo	xoxolo
pel	pepel
zyleqkux	zyzyleqkux
jypgilsixyxve	jyjypgilsixyxve
dyxogixzo	dydyxogixzo
fygansiwhake	fyfygansiwhake
juxexa	jujuxexa
rokqodmislywu	rorokqodmislywu
lytodaq	lylytodaq
synpa	sysynpa
babo	bababo
vatyfobognir	vavatyfobognir
sebor	sesebor
ryjdonad	ryryjdonad
qopy	qoqopy
hyjeca	hyhyjeca
wocob	wowocob
faf	fafaf
jebev	jejebev
hozuzugypyq	hohozuzugypyq
wyticmugfoxhot	wywyticmugfoxhot
datvociwirjoc	dadatvociwirjoc
sutrog	susutrog
kodsol	kokodsol
ben	beben
debo	dedebo
dugmo	dudugmo
naskufdow	nanaskufdow
cunizzigden	cucunizzigden
ducbi	duducbi
puzydqy	pupuzydqy
xocqoso	xoxocqoso
bozhep	bobozhep
cidpik	cicidpik
nijfyfesyl	ninijfyfesyl
kosidky	kokosidky
zypwabi	zyzypwabi
focu	fofocu
safi	sasafi
qosjyn	qoqosjyn
gesad	gegesad
ciwfihikzyze	ciciwfihikzyze
lyfuj	lylyfuj
wasnipexqubok	wawasnipexqubok
vawo	vavawo
mafa	mamafa
kahah	kakahah
rak	rarak
zijyw	zizijyw
ropedqaf	roropedqaf
veguw	veveguw
buhi	bubuhi
lyroxkikda	lylyroxkikda
fajnoc	fafajnoc
tolnofcoj	totolnofcoj
mesexwi	memesexwi
pajoracim	papajoracim
gukkymtovki	gugukkymtovki
lasy	lalasy
mufil	mumufil
vicur	vivicur
nexcyvojta	nenexcyvojta
tugsox	tutugsox
horwy	hohorwy
furifge	fufurifge
dylibud	dydylibud
huminxuj	huhuminxuj
qyvul	qyqyvul
jujqafixi	jujujqafixi
jottyxu	jojottyxu
wonara	wowonara
zyksazlytke	zyzyksazlytke
fixe	fifixe
behpacipuzzo	bebehpacipuzzo
lobqe	lolobqe
wifkukitqom	wiwifkukitqom
sobkij	sosobkij
sempe	sesempe
vavikatezow	vavavikatezow
qalril	qaqalril
kaj	kakaj
xesuv	xexesuv
lysnemhyv	lylysnemhyv
bizibfe	bibizibfe
fulaquncignuj	fufulaquncignuj
tili	titili
deby	dedeby
feleli	fefeleli
qydam	qyqydam
leblikex	leleblikex
nu	nunu
cug	cucug
botqis	bobotqis
hysi	hyhysi
jalax	jajalax
ductiqbyre	duductiqbyre
sunuhaktiv	susunuhaktiv
vukaznuvramxiv	vuvukaznuvramxiv
repvudgefrax	rerepvudgefrax
lehez	lelehez
nowsol	nonowsol
gaqqeble	gagaqqeble
nago	nanago
sumyzoj	susumyzoj
bagag	babagag
toglodnujjoz	totoglodnujjoz
xyreq	xyxyreq
pig	pipig
webomti	wewebomti
kopcomzexre	kokopcomzexre
gib	gigib
wiker	wiwiker
hapirjy	hahapirjy
qybze	qyqybze
mocaf	momocaf
lejtaldak	lelejtaldak
veqipqy	veveqipqy
notdoxcewpi	nonotdoxcewpi
jigiqfy	jijigiqfy
turvizguq	tuturvizguq
howoxgyvruq	hohowoxgyvruq
fenvupu	fefenvupu
tekzef	tetekzef
nifuvzev	ninifuvzev
quzit	ququzit
fipreka	fifipreka
woryseghed	woworyseghed
totogegydre	tototogegydre
qachylisdyjsyk	qaqachylisdyjsyk
wuwi	wuwuwi
hewepnimzij	hehewepnimzij
nopwesobmy	nonopwesobmy
hakhylan	hahakhylan
bycxehlyj	bybycxehlyj
zarijraremla	zazarijraremla
qyty	qyqyty
tyx	tytyx
tevnylteja	tetevnylteja
mulazhev	mumulazhev
tanodiwi	tatanodiwi
qupren	ququpren
zuciv	zuzuciv
silhocsecca	sisilhocsecca
vabmogug	vavabmogug
hecin	hehecin
jiribqe	jijiribqe
doqsa	dodoqsa
vyqodzovuw	vyvyqodzovuw
lobtewyc	lolobtewyc
buhqofub	bubuhqofub
venpy	vevenpy
fekoral	fefekoral
fogut	fofogut
cexux	cecexux
fugyh	fufugyh
weja	weweja
tujvev	tutujvev
lamajysate	lalamajysate
dat	dadat
lumepbyg	lulumepbyg
pasfanfozigbu	papasfanfozigbu
nyfidqokoxaw	nynyfidqokoxaw
miziwifozu	mimiziwifozu
kitnywo	kikitnywo
depsu	dedepsu
zaqevy	zazaqevy
nurcyh	nunurcyh
balo	babalo
juxa	jujuxa
favbu	fafavbu
xiqfy	xixiqfy
tisfoliwsuw	titisfoliwsuw
juxnigdohonif	jujuxnigdohonif
mabnepysjolup	mamabnepysjolup
buzno	bubuzno
qurixpi	ququrixpi
kil	kikil
lucgy	lulucgy
xyldekvidefak	xyxyldekvidefak
muka	mumuka
xonwozuguj	xoxonwozuguj
pexcujce	pepexcujce
benlu	bebenlu
muwokesxi	mumuwokesxi
caqni	cacaqni
silpy	sisilpy
lemod	lelemod
nozhegryk	nonozhegryk
begag	bebegag
maxaqcimig	mamaxaqcimig
fiqub	fifiqub
nedu	nenedu
fugla	fufugla
ris	riris
perfecrym	peperfecrym
qabik	qaqabik
citmyh	cicitmyh
wuduqzussipe	wuwuduqzussipe
tug	tutug
xanuj	xaxanuj
jol	jojol
fatuwfegrobo	fafatuwfegrobo
qizeby	qiqizeby
qajfo	qaqajfo
toqvejeda	totoqvejeda
punpam	pupunpam
devi	dedevi
nyre	nynyre
zafakutafgi	zazafakutafgi
foqos	fofoqos
muqqisabqudna	mumuqqisabqudna
kodur	kokodur
rygu	ryrygu
dewkamsa	dedewkamsa
butvyrmo	bubutvyrmo
jevuwijuzge	jejevuwijuzge
gasleq	gagasleq
mezuffi	memezuffi
pepkoc	pepepkoc
sosqihpu	sososqihpu
byjopykogma	bybyjopykogma
jakubohyko	jajakubohyko
kacleq	kakacleq
copuzju	cocopuzju
soj	sosoj
jafbycyb	jajafbycyb
qisalzuhxynpaw	qiqisalzuhxynpaw
lizvi	lilizvi
sylajhuxfyq	sysylajhuxfyq
noqalcogo	nonoqalcogo
gomy	gogomy
copan	cocopan
cabecamxy	cacabecamxy
vesne	vevesne
bete	bebete
cev	cecev
tew	tetew
cedy	cecedy
worqij	woworqij
semtunmiglem	sesemtunmiglem
negmu	nenegmu
dyvcodo	dydyvcodo
huqeh	huhuqeh
vowa	vovowa
hituqymwa	hihituqymwa
jofixry	jojofixry
lendyvxenvumo	lelendyvxenvumo
kyksokmin	kykyksokmin
cifozge	cicifozge
fygyka	fyfygyka
loc	loloc
finotuv	fifinotuv
zudimdag	zuzudimdag
welbesyhjuha	wewelbesyhjuha
xupin	xuxupin
tasbywmohyq	tatasbywmohyq
wulsyxponitxu	wuwulsyxponitxu
qujky	ququjky
vykesanve	vyvykesanve
bybuvnymev	bybybuvnymev
pos	popos
leqy	leleqy
toqimyruvxoh	totoqimyruvxoh
cimowix	cicimowix
cuhit	cucuhit
zejgyji	zezejgyji
dany	dadany
vobyq	vovobyq
mizujjef	mimizujjef
negeh	nenegeh
zyvavryl	zyzyvavryl
jypjuhreh	jyjypjuhreh
nipojvup	ninipojvup
moqhyxu	momoqhyxu
dozxadpe	dodozxadpe
doh	dodoh
monqaqjyz	momonqaqjyz
cozzic	cocozzic
weqonqiffoliv	weweqonqiffoliv
mogu	momogu
suqma	susuqma
vibxuv	vivibxuv
lif	lilif
viwunremymtov	viviwunremymtov
ryk	ryryk
desamvawledeh	dedesamvawledeh
hakpy	hahakpy
jyjlez	jyjyjlez
hikha	hihikha
savsi	sasavsi
vatumky	vavatumky
qyxfuzzegolo	qyqyxfuzzegolo
nilil	ninilil
humilat	huhumilat
lalomu	lalalomu
gafy	gagafy
nyd	nynyd
mozufedi	momozufedi
nyk	nynyk
dinkoken	didinkoken
catbe	cacatbe
tegrohid	tetegrohid
mytne	mymytne
fyq	fyfyq
sugi	susugi
pud	pupud
hytnibo	hyhytnibo
rilsywpyxsesa	ririlsywpyxsesa
dovpo	dodovpo
gizle	gigizle
qyhrysyk	qyqyhrysyk
pojin	popojin
mytemhe	mymytemhe
bec	bebec
dezina	dedezina
keji	kekeji
hyg	hyhyg
xuxfem	xuxuxfem
lifqinjimquflen	lilifqinjimquflen
fuhixe	fufuhixe
xejtix	xexejtix
gaqejomipi	gagaqejomipi
jofi	jojofi
kuvfup	kukuvfup
nyt	nynyt
dali	dadali
tupu	tutupu
rof	rorof
cewi	cecewi
mutyryw	mumutyryw
pyddycivka	pypyddycivka
fevuk	fefevuk
lup	lulup
bahpi	babahpi
sywec	sysywec
hivunnedom	hihivunnedom
qirog	qiqirog
xosax	xoxosax
wacza	wawacza
vyj	vyvyj
lur	lulur
cox	cocox
gukhoh	gugukhoh
hymuf	hyhymuf
cih	cicih
fika	fifika
gywit	gygywit
rowakojkyb	rorowakojkyb
coxpuktuhwom	cocoxpuktuhwom
pefasigihxe	pepefasigihxe
kowgos	kokowgos
bon	bobon
selzu	seselzu
xotolirajfu	xoxotolirajfu
neloxcitlatxi	neneloxcitlatxi
ruwe	ruruwe
lazysodxorqo	lalazysodxorqo
jiwaz	jijiwaz
kehi	kekehi
xumapew	xuxumapew
nenmuho	nenenmuho
zolbo	zozolbo
rihcav	ririhcav
sufrybyz	susufrybyz
cajfu	cacajfu
bety	bebety
cibawbub	cicibawbub
foti	fofoti
dehbe	dedehbe
tevaqzoreja	tetevaqzoreja
kojypha	kokojypha
fyxjosgipo	fyfyxjosgipo
zihni	zizihni
zifhulnogu	zizifhulnogu
zuz	zuzuz
tabjadry	tatabjadry
gaffig	gagaffig
cozrydver	cocozrydver
vapujkumexu	vavapujkumexu
vywwuxowy	vyvywwuxowy
hesxof	hehesxof
vijihzec	vivijihzec
bucgyrsebovuc	bubucgyrsebovuc
taxweq	tataxweq
kygsev	kykygsev
sejfudit	sesejfudit
zyfvosa	zyzyfvosa
jaz	jajaz
zothek	zozothek
xurwyfowfenpah	xuxurwyfowfenpah
xyrxuzusvu	xyxyrxuzusvu
kob	kokob
komzab	kokomzab
dypujiz	dydypujiz
fescoqek	fefescoqek
xufijaky	xuxufijaky
diryhlic	didiryhlic
gunfesuznehcyj	gugunfesuznehcyj
ka	kaka
pujynqi	pupujynqi
bowdabu	bobowdabu
heluqzy	heheluqzy
rolno	rorolno
fiqe	fifiqe
bubhahe	bububhahe
qociswux	qoqociswux
zure	zuzure
hudapzozwo	huhudapzozwo
cerejongoqmox	cecerejongoqmox
dofxu	dodofxu
catunwe	cacatunwe
qajduphi	qaqajduphi
vinaxgufna	vivinaxgufna
myrortumvez	mymyrortumvez
pusoto	pupusoto
xyfun	xyxyfun
zebnud	zezebnud
baj	babaj
hojgifsibbe	hohojgifsibbe
joqyjkuv	jojoqyjkuv
valakmodpiz	vavalakmodpiz
cycymeby	cycycymeby
dizi	didizi
rejny	rerejny
fervyj	fefervyj
zeqopxyprewxe	zezeqopxyprewxe
woful	wowoful
deli	dedeli
fu	fufu
hahkabungyfjew	hahahkabungyfjew
geqolulatub	gegeqolulatub
naxesolwykej	nanaxesolwykej
belcup	bebelcup
banro	babanro
wemipnu	wewemipnu
zawpol	zazawpol
fihwek	fifihwek
jybnobob	jyjybnobob
ryfsivvyrgirte	ryryfsivvyrgirte
duswysag	duduswysag
ses	seses
wowqy	wowowqy
puhi	pupuhi
hob	hohob
xonwaskiz	xoxonwaskiz
zami	zazami
kiluzu	kikiluzu
bix	bibix
qafufwex	qaqafufwex
vuloxejylfaj	vuvuloxejylfaj
saspuwcuw	sasaspuwcuw
bajji	babajji
hinvaj	hihinvaj
qoxiq	qoqoxiq
girpi	gigirpi
jedirjo	jejedirjo
xodjokroma	xoxodjokroma
lusnobez	lulusnobez
zyfo	zyzyfo
doxkumnyh	dodoxkumnyh
fegronmijef	fefegronmijef
qul	ququl
xewde	xexewde
ryges	ryryges
zowvus	zozowvus
nodhe	nonodhe
dodyqho	dododyqho
xiloggud	xixiloggud
qifyjzu	qiqifyjzu
sug	susug
symy	sysymy
quhiwkasrur	ququhiwkasrur
vywdumybazpo	vyvywdumybazpo
wustov	wuwustov
myzanly	mymyzanly
facy	fafacy
losrugtu	lolosrugtu
vog	vovog
heklivsyghy	heheklivsyghy
puku	pupuku
syror	sysyror
delyg	dedelyg
jabtyxce	jajabtyxce
kofjiwivi	kokofjiwivi
rytu	ryrytu
vixwakadkiv	vivixwakadkiv
vanubon	vavanubon
fiwi	fifiwi
mocylco	momocylco
pyro	pypyro
tolbowusuv	totolbowusuv
roqkec	roroqkec
lenpaz	lelenpaz
noqudub	nonoqudub
luvwub	luluvwub
xuhuwhyt	xuxuhuwhyt
bucpybxa	bubucpybxa
powcu	popowcu
cybok	cycybok
guju	guguju
luhul	luluhul
kacac	kakacac
sobmecfefveky	sosobmecfefveky
coc	cococ
dibeser	didibeser
nep	nenep
surydwan	susurydwan
wobsy	wowobsy
mirliqimater	mimirliqimater
donekbow	dodonekbow
bidyv	bibidyv
sogrelfuga	sosogrelfuga
kafwerpy	kakafwerpy
lurum	lulurum
dohypyk	dodohypyk
worduw	woworduw
damhobgir	dadamhobgir
nugy	nunugy
vucy	vuvucy
zawekurgyl	zazawekurgyl
hunryjgagnuclid	huhunryjgagnuclid
bymifuslu	bybymifuslu
tofnyg	totofnyg
xogquqwodjiv	xoxogquqwodjiv
jahzyhji	jajahzyhji
mucu	mumucu
lyjfevecym	lylyjfevecym
vitefyzwa	vivitefyzwa
gaq	gagaq
mehuleco	memehuleco
cucebofxub	cucucebofxub
dighy	didighy
dibef	didibef
jycwageh	jyjycwageh
gynho	gygynho
nasticersozyb	nanasticersozyb
wupzyw	wuwupzyw
mymiq	mymymiq
wasfokixy	wawasfokixy
vov	vovov
vulazsepy	vuvulazsepy
mydcemo	mymydcemo
poxfu	popoxfu
fihasa	fifihasa
cesyk	cecesyk
wupfut	wuwupfut
cavpokob	cacavpokob
hak	hahak
bimwigkowvermy	bibimwigkowvermy
cordab	cocordab
bowqiv	bobowqiv
zazdexnyw	zazazdexnyw
qange	qaqange
gyn	gygyn
dicaqqopi	didicaqqopi
roduq	roroduq
mewyq	memewyq
wywottax	wywywottax
vyki	vyvyki
piti	pipiti
gaxuj	gagaxuj
viqabriq	viviqabriq
lu	lulu
vuzowyvlu	vuvuzowyvlu
fyrfo	fyfyrfo
gunlo	gugunlo
ryxot	ryryxot
subpyx	susubpyx
xora	xoxora
qeludvezot	qeqeludvezot
fusgepy	fufusgepy
dispygarac	didispygarac
cyzedvi	cycyzedvi
dukwez	dudukwez
fybhe	fyfybhe
piva	pipiva
cobezhu	cocobezhu
misetqetexbo	mimisetqetexbo
rahytazhy	rarahytazhy
nolmyk	nonolmyk
xinkisased	xixinkisased
zididitoxkuw	zizididitoxkuw
pytvomxow	pypytvomxow
nehku	nenehku
hobus	hohobus
lycazhyg	lylycazhyg
notikek	nonotikek
poxgad	popoxgad
nabvyz	nanabvyz
cu	cucu
biguz	bibiguz
faznuthipdat	fafaznuthipdat
regu	reregu
voj	vovoj
sesuw	sesesuw
vun	vuvun
peziz	pepeziz
hyn	hyhyn
dif	didif
nig	ninig
rep	rerep
dibonzyzaz	didibonzyzaz
vifkapryj	vivifkapryj
jiphybfa	jijiphybfa
cakorjobapac	cacakorjobapac
tadzid	tatadzid
morbi	momorbi
ril	riril
fuqoq	fufuqoq
cudy	cucudy
tarqefaf	tatarqefaf
hacfajcop	hahacfajcop
qozol	qoqozol
qalutepafi	qaqalutepafi
xupo	xuxupo
div	didiv
gamhu	gagamhu
dypfa	dydypfa
vappopejah	vavappopejah
lejgidwaz	lelejgidwaz
dopki	dodopki
bewqew	bebewqew
pybyz	pypybyz
momugakehes	momomugakehes
carsededcim	cacarsededcim
josyp	jojosyp
hovolfe	hohovolfe
gikfebru	gigikfebru
todexequdnyt	totodexequdnyt
dasheqqop	dadasheqqop
sepuk	sesepuk
nusni	nunusni
wuhmalekhaq	wuwuhmalekhaq
xecve	xexecve
jenu	jejenu
bapcuq	babapcuq
gomgako	gogomgako
tasatqoqsi	tatasatqoqsi
piwe	pipiwe
lykom	lylykom
dovwep	dodovwep
tihuhy	titihuhy
vuszequt	vuvuszequt
velsi	vevelsi
wicsoknojjiwkus	wiwicsoknojjiwkus
hykna	hyhykna
kof	kokof
zulozuxtopxup	zuzulozuxtopxup
raglejaf	raraglejaf
lorju	lolorju
qyqta	qyqyqta
pigde	pipigde
julkicxa	jujulkicxa
vecorytok	vevecorytok
bonesi	bobonesi
nyzbu	nynyzbu
nibo	ninibo
sypsiwul	sysypsiwul
helod	hehelod
jusiboqtiwa	jujusiboqtiwa
vala	vavala
wuqropy	wuwuqropy
lewi	lelewi
cobfy	cocobfy
byrlu	bybyrlu
kofehpehe	kokofehpehe
jemu	jejemu
jot	jojot
zevcypvenjetu	zezevcypvenjetu
kyftuqyhipo	kykyftuqyhipo
kived	kikived
puguqtubmir	pupuguqtubmir
demal	dedemal
bypu	bybypu
tezgor	tetezgor
mewki	memewki
feh	fefeh
zarkob	zazarkob
jodretiw	jojodretiw
seg	seseg
gygcy	gygygcy
lit	lilit
tizohzo	titizohzo
kicywvuzofy	kikicywvuzofy
cagakhu	cacagakhu
maclu	mamaclu
gocados	gogocados
cimop	cicimop
hel	hehel
molgez	momolgez
buhu	bubuhu
qiva	qiqiva
matyx	mamatyx
huver	huhuver
depa	dedepa
sanigym	sasanigym
kitcow	kikitcow
pynropi	pypynropi
zydzosajdol	zyzydzosajdol
max	mamax
dox	dodox
pecel	pepecel
qemlu	qeqemlu
tuk	tutuk
xixuji	xixixuji
mowvibnyp	momowvibnyp
like	lilike
faptykegogu	fafaptykegogu
qyqkowijhymu	qyqyqkowijhymu
nelju	nenelju
latpo	lalatpo
bymem	bybymem
jer	jejer
zude	zuzude
rutcygaz	rurutcygaz
garran	gagarran
remhiz	reremhiz
donzihelwe	dodonzihelwe
fihvihzuq	fifihvihzuq
xiwuhhymfafnoc	xixiwuhhymfafnoc
cimnotlutidwy	cicimnotlutidwy
naqwif	nanaqwif
kypu	kykypu
qesryqi	qeqesryqi
mypme	mymypme
vobo	vovobo
puplysej	pupuplysej
covud	cocovud
cigfobo	cicigfobo
pykzym	pypykzym
vafnev	vavafnev
nawiweb	nanawiweb
rufezy	rurufezy
nuspytwojorfo	nunuspytwojorfo
kovo	kokovo
zewza	zezewza
ditnu	diditnu
sazuf	sasazuf
xybah	xyxybah
gimkyhycak	gigimkyhycak
gotbyz	gogotbyz
lysor	lylysor
favsy	fafavsy
vagerob	vavagerob
kecvy	kekecvy
ricdocmoblojbe	riricdocmoblojbe
xubinmelobny	xuxubinmelobny
ryqebot	ryryqebot
lakqifnob	lalakqifnob
hejrovic	hehejrovic
lona	lolona
zohso	zozohso
xufugbel	xuxufugbel
kyxpag	kykyxpag
pidwi	pipidwi
soma	sosoma
xibo	xixibo
cyhlox	cycyhlox
haxipamowok	hahaxipamowok
juqu	jujuqu
wuvip	wuwuvip
cozavvubpep	cocozavvubpep
kabom	kakabom
keqif	kekeqif
mupciqdi	mumupciqdi
vad	vavad
ganpe	gaganpe
vuwic	vuvuwic
zypdu	zyzypdu
rijulyv	ririjulyv
va	vava
poheb	popoheb
zaseqbem	zazaseqbem
dibjug	didibjug
dulqus	dudulqus
terezod	teterezod
byzbyxorucy	bybyzbyxorucy
wuhohvy	wuwuhohvy
vuwfy	vuvuwfy
zexy	zezexy
qipnuh	qiqipnuh
sewbu	sesewbu
nywi	nynywi
wezbehungabi	wewezbehungabi
depihu	dedepihu
nocly	nonocly
bywo	bybywo
reflyp	rereflyp
vurtizvi	vuvurtizvi
vyddaped	vyvyddaped
lujpuljik	lulujpuljik
nydoqifgyc	nynydoqifgyc
siftac	sisiftac
qygyzogyz	qyqygyzogyz
fipdal	fifipdal
sona	sosona
fesa	fefesa
haxre	hahaxre
galwym	gagalwym
motoc	momotoc
liso	liliso
fajipjy	fafajipjy
voma	vovoma
zulub	zuzulub
havog	hahavog
nycfok	nynycfok
kofej	kokofej
lovejiglit	lolovejiglit
balertesub	babalertesub
hesciwfudsew	hehesciwfudsew
jofem	jojofem
tepog	tetepog
zeqonte	zezeqonte
dawos	dadawos
jawky	jajawky
tuzmokgo	tutuzmokgo
micu	mimicu
hiwxus	hihiwxus
luvudi	luluvudi
pecuna	pepecuna
myhre	mymyhre
dongys	dodongys
kuvdyk	kukuvdyk
cikyzaxcyj	cicikyzaxcyj
lyny	lylyny
vodhegpisha	vovodhegpisha
kypbim	kykypbim
kemdi	kekemdi
tecucro	tetecucro
zeroracfujyp	zezeroracfujyp
nuvugy	nunuvugy
vilre	vivilre
togot	totogot
sapji	sasapji
wyhatespa	wywyhatespa
kodwo	kokodwo
mif	mimif
lymfigtyfo	lylymfigtyfo
viguxalqykrak	viviguxalqykrak
woluf	wowoluf
dypmelovy	dydypmelovy
mos	momos
xixsez	xixixsez
xir	xixir
katihymac	kakatihymac
tugwo	tutugwo
xorontynmahxa	xoxorontynmahxa
xani	xaxani
kolrywbegetce	kokolrywbegetce
kegjabhajwik	kekegjabhajwik
wap	wawap
tub	tutub
jydipgadymcy	jyjydipgadymcy
zejgof	zezejgof
gygherwax	gygygherwax
xomxyrroqu	xoxomxyrroqu
vixisve	vivixisve
gegqik	gegegqik
rorwor	rororwor
dyctihi	dydyctihi
kadopom	kakadopom
fahmyt	fafahmyt
tukymba	tutukymba
muvunfuxto	mumuvunfuxto
revehvy	rerevehvy
wujcyfkyn	wuwujcyfkyn
vylha	vyvylha
honun	hohonun
wuzys	wuwuzys
loszaq	loloszaq
xehiqwe	xexehiqwe
wez	wewez
rakup	rarakup
cazutyn	cacazutyn
kynuwdy	kykynuwdy
suzga	susuzga
risviw	ririsviw
jynpo	jyjynpo
vugligwo	vuvugligwo
pyry	pypyry
waw	wawaw
sodsic	sosodsic
towcujqarav	totowcujqarav
xydnolxa	xyxydnolxa
jyfoqwyngag	jyjyfoqwyngag
nexyx	nenexyx
tevesbozi	tetevesbozi
jagof	jajagof
pumxyqwek	pupumxyqwek
hyjmumwes	hyhyjmumwes
kyz	kykyz
tuctiwzuvdekid	tutuctiwzuvdekid
coryzi	cocoryzi
cuga	cucuga
bewinceftujxur	bebewinceftujxur
pomxytban	popomxytban
xesfomhafylkyz	xexesfomhafylkyz
piwdap	pipiwdap
tirwij	titirwij
wizvar	wiwizvar
nyxkagfa	nynyxkagfa
gudcopvice	gugudcopvice
tyje	tytyje
qucovi	ququcovi
fave	fafave
rat	rarat
pahet	papahet
jorxasva	jojorxasva
gidtitmuj	gigidtitmuj
tupubpyf	tutupubpyf
dobpuva	dodobpuva
batbe	babatbe
myga	mymyga
cumufzudy	cucumufzudy
pagpygo	papagpygo
lode	lolode
mummy	mumummy
cabup	cacabup
genex	gegenex
buqelisfobik	bubuqelisfobik
nijo	ninijo
qih	qiqih
basqo	babasqo
diwguv	didiwguv
finzam	fifinzam
gixqoldaxja	gigixqoldaxja
hafykapofow	hahafykapofow
qim	qiqim
bekecgyg	bebekecgyg
dyzuqo	dydyzuqo
gocez	gogocez
dehnoge	dedehnoge
gaffa	gagaffa
gemmivu	gegemmivu
mewbi	memewbi
sukofajhitob	susukofajhitob
bepuj	bebepuj
vizqadimyvsyt	vivizqadimyvsyt
tun	tutun
syt	sysyt
pofgew	popofgew
fubcowojo	fufubcowojo
bibihsic	bibibihsic
wuminawsicog	wuwuminawsicog
mec	memec
xuzpi	xuxuzpi
ginhekug	giginhekug
tir	titir
fyqexda	fyfyqexda
lilivgofhexuc	lililivgofhexuc
nad	nanad
myhgyliskaxqaf	mymyhgyliskaxqaf
tekijxodqu	tetekijxodqu
zojkeq	zozojkeq
liswe	liliswe
losiz	lolosiz
viqecuz	viviqecuz
zaqy	zazaqy
quk	ququk
loh	loloh
dyrulud	dydyrulud
fylbicfyntani	fyfylbicfyntani
vetenwip	vevetenwip
cowdagup	cocowdagup
sehnap	sesehnap
gegigfu	gegegigfu
daky	dadaky
vonud	vovonud
qiluksi	qiqiluksi
leti	leleti
zamabqadajgeq	zazamabqadajgeq
cevqatas	cecevqatas
jakasxe	jajakasxe
bufcilmugbu	bubufcilmugbu
qulo	ququlo
xuqo	xuxuqo
rali	rarali
cufmurfy	cucufmurfy
ticy	titicy
josuqarpilhol	jojosuqarpilhol
jyn	jyjyn
xywme	xyxywme
julwoqfi	jujulwoqfi
vyvqa	vyvyvqa
bymni	bybymni
kuko	kukuko
zaf	zazaf
puqy	pupuqy
pysycoq	pypysycoq
nofag	nonofag
waqhu	wawaqhu
fuven	fufuven
vim	vivim
lubpa	lulubpa
neri	neneri
suqcednocohe	susuqcednocohe
zebuzrym	zezebuzrym
ror	roror
rafry	rarafry
qogowja	qoqogowja
doqikvohecu	dodoqikvohecu
tiqaq	titiqaq
zity	zizity
sovij	sosovij
coh	cocoh
mecoq	memecoq
diqlykomux	didiqlykomux
fifug	fififug
ruggi	ruruggi
weqveharizfir	weweqveharizfir
mogohgyj	momogohgyj
marva	mamarva
xyh	xyxyh
gymmazer	gygymmazer
tejxeflojgo	tetejxeflojgo
xorgumgabfamma	xoxorgumgabfamma
xazizo	xaxazizo
vehyn	vevehyn
lynu	lylynu
jilcu	jijilcu
gany	gagany
godribhebpagod	gogodribhebpagod
zixiruwulvas	zizixiruwulvas
jagxo	jajagxo
ranbok	raranbok
dic	didic
gevmyvi	gegevmyvi
nymati	nynymati
werpu	wewerpu
jokbyhbelzeh	jojokbyhbelzeh
kikozuglax	kikikozuglax
wage	wawage
nodkyvax	nonodkyvax
lyrgyjje	lylyrgyjje
ponybcadxuwvy	poponybcadxuwvy
hoxxiwaz	hohoxxiwaz
kaw	kakaw
cafryxoj	cacafryxoj
lumo	lulumo
pipqulmacbu	pipipqulmacbu
kimxodigwez	kikimxodigwez
mucgakucpulgiz	mumucgakucpulgiz
ryrwic	ryryrwic
fihvah	fifihvah
rahexu	rarahexu
bydwivke	bybydwivke
tesema	tetesema
gipguv	gigipguv
hacipjoplozi	hahacipjoplozi
kuli	kukuli
xyvheda	xyxyvheda
wifih	wiwifih
hihi	hihihi
tul	tutul
fexa	fefexa
myfylrocot	mymyfylrocot
walsygbi	wawalsygbi
pefofsicfycly	pepefofsicfycly
vyqsuv	vyvyqsuv
vegqu	vevegqu
lyzpus	lylyzpus
muhlilvy	mumuhlilvy
mujilavlu	mumujilavlu
coby	cocoby
nymev	nynymev
pyqo	pypyqo
nom	nonom
gil	gigil
juk	jujuk
movwi	momovwi
vodujzovyqpez	vovodujzovyqpez
jekyvepydik	jejekyvepydik
sertaf	sesertaf
rure	rurure
gifhiherepad	gigifhiherepad
qovurkiqta	qoqovurkiqta
kofub	kokofub
badibu	babadibu
ryxyk	ryryxyk
luskybmif	luluskybmif
rysalre	ryrysalre
vojakamgyvqe	vovojakamgyvqe
vuhfozja	vuvuhfozja
gekzoc	gegekzoc
nywwon	nynywwon
vesuma	vevesuma
cattyfzen	cacattyfzen
sob	sosob
qoni	qoqoni
jifyp	jijifyp
fufilvasekci	fufufilvasekci
tepox	tetepox
lisajyzjer	lilisajyzjer
duffezqygefvyr	duduffezqygefvyr
kykirhenpit	kykykirhenpit
vozy	vovozy
qegaf	qeqegaf
tuglud	tutuglud
fofhimrik	fofofhimrik
mude	mumude
wocqeb	wowocqeb
nilmic	ninilmic
rypyk	ryrypyk
junka	jujunka
demiba	dedemiba
hynewsijxyzu	hyhynewsijxyzu
vuquw	vuvuquw
xypkoqydraser	xyxypkoqydraser
rufho	rurufho
fiho	fifiho
darlu	dadarlu
gecuwomfu	gegecuwomfu
sefy	sesefy
jyhuz	jyjyhuz
rotubar	rorotubar
zic	zizic
towdi	totowdi
zivaqy	zizivaqy
sypsim	sysypsim
jifrurikbokak	jijifrurikbokak
zehzocmiber	zezehzocmiber
vyjoq	vyvyjoq
buzcaf	bubuzcaf
niwaw	niniwaw
gisox	gigisox
xapux	xaxapux
hygbe	hyhygbe
pohponykkuw	popohponykkuw
degxeszanta	dedegxeszanta
tet	tetet
larwu	lalarwu
wefnibpaj	wewefnibpaj
mimqamnygibo	mimimqamnygibo
xuwqahegza	xuxuwqahegza
parsyq	paparsyq
zohu	zozohu
cac	cacac
qyhcosjewocma	qyqyhcosjewocma
faxpiscigvat	fafaxpiscigvat
nod	nonod
sifis	sisifis
pys	pypys
vojam	vovojam
doditolox	dododitolox
varaqso	vavaraqso
zanjej	zazanjej
koli	kokoli
sujuqahzubyc	susujuqahzubyc
mubuf	mumubuf
peguxvyw	pepeguxvyw
ziqi	ziziqi
caxew	cacaxew
bewma	bebewma
buhe	bubuhe
kidacofgoki	kikidacofgoki
nopvuxso	nonopvuxso
jux	jujux
mebor	memebor
cadi	cacadi
xaqwijny	xaxaqwijny
jomkalam	jojomkalam
pybig	pypybig
gomse	gogomse
dyvwax	dydyvwax
kuxoxguf	kukuxoxguf
zolurqu	zozolurqu
mikjemlil	mimikjemlil
janutajnyffa	jajanutajnyffa
jis	jijis
gaje	gagaje
ceffijme	ceceffijme
qumoq	ququmoq
buk	bubuk
pame	papame
raty	raraty
pyvazoqjew	pypyvazoqjew
roliw	roroliw
nyfaluv	nynyfaluv
zolyzyv	zozolyzyv
kiwicwenuwam	kikiwicwenuwam
sisak	sisisak
nudbis	nunudbis
liqsas	liliqsas
ruha	ruruha
simi	sisimi
hikbop	hihikbop
haxqozupyr	hahaxqozupyr
vofvakterizan	vovofvakterizan
jibwaf	jijibwaf
sicqe	sisicqe
pusnos	pupusnos
pynydzi	pypynydzi
valjex	vavaljex
zeb	zezeb
dawxan	dadawxan
zezuv	zezezuv
zyjimlixcuf	zyzyjimlixcuf
dywow	dydywow
qoxsuv	qoqoxsuv
hyju	hyhyju
mecizuz	memecizuz
qod	qoqod
ron	roron
sevabze	sesevabze
kikxorole	kikikxorole
lyqa	lylyqa
popxe	popopxe
fugge	fufugge
qatsaxxy	qaqatsaxxy
qodaf	qoqodaf
raqutmac	raraqutmac
mudi	mumudi
kybusywpa	kykybusywpa
wasvyfimmizpo	wawasvyfimmizpo
veg	veveg
qixebzyh	qiqixebzyh
xoqizxaso	xoxoqizxaso
qypsaxgiwo	qyqypsaxgiwo
qyfve	qyqyfve
midebe	mimidebe
lybsehqybas	lylybsehqybas
gyty	gygyty
rowebok	rorowebok
vukpecharuqbo	vuvukpecharuqbo
buhul	bubuhul
qyhdy	qyqyhdy
hasli	hahasli
cig	cicig
nijhus	ninijhus
bulfahom	bubulfahom
nyny	nynyny
qofmys	qoqofmys
qide	qiqide
melbele	memelbele
noqcaqpelaz	nonoqcaqpelaz
qipyrwy	qiqipyrwy
cezpohi	cecezpohi
wemcowdy	wewemcowdy
fopqof	fofopqof
vofpazarxyfe	vovofpazarxyfe
giwset	gigiwset
rimwaz	ririmwaz
julavcuq	jujulavcuq
qoxdop	qoqoxdop
dufkovbo	dudufkovbo
nyvgasozydtyr	nynyvgasozydtyr
mekyfjisno	memekyfjisno
wamlebozsivrom	wawamlebozsivrom
nory	nonory
kori	kokori
xaxegfegdy	xaxaxegfegdy
sawi	sasawi
kybcyhvunevkap	kykybcyhvunevkap
difirotpid	didifirotpid
soxedorah	sosoxedorah
rokyjre	rorokyjre
maxrakev	mamaxrakev
kuz	kukuz
tipi	titipi
sif	sisif
sacemgi	sasacemgi
xej	xexej
zovawnegoqed	zozovawnegoqed
nixhelogmy	ninixhelogmy
famar	fafamar
fihup	fifihup
zifzuh	zizifzuh
doxibenpe	dodoxibenpe
hugxodwaf	huhugxodwaf
tuwxev	tutuwxev
jeqoz	jejeqoz
wozi	wowozi
zidaqkulsule	zizidaqkulsule
tugatko	tutugatko
qikisqu	qiqikisqu
geftip	gegeftip
pit	pipit
qemhi	qeqemhi
kavowe	kakavowe
cumsydrib	cucumsydrib
nib	ninib
wyt	wywyt
zimekevomziz	zizimekevomziz
depiz	dedepiz
cyv	cycyv
nuro	nunuro
dybzepdiz	dydybzepdiz
fyjxeq	fyfyjxeq
mihocy	mimihocy
qummar	quqummar
quwywuw	ququwywuw
vyto	vyvyto
didbyceropy	dididbyceropy
cecimexi	cececimexi
recub	rerecub
barin	babarin
nurged	nunurged
vudcuw	vuvudcuw
tuvuc	tutuvuc
bynanustud	bybynanustud
fiwdub	fifiwdub
qewuhi	qeqewuhi
zez	zezez
xenirlofetu	xexenirlofetu
pewwu	pepewwu
kijde	kikijde
mydpym	mymydpym
jopxelofweq	jojopxelofweq
fysov	fyfysov
des	dedes
feqajve	fefeqajve
fogbopyg	fofogbopyg
qylacfik	qyqylacfik
xamde	xaxamde
qiniklusex	qiqiniklusex
deduc	dededuc
temac	tetemac
tekqysnufud	tetekqysnufud
vutul	vuvutul
necju	nenecju
mesote	memesote
nivqip	ninivqip
wihmu	wiwihmu
sucokho	susucokho
sonfig	sosonfig
reni	rereni
quhcimpy	ququhcimpy
qotlypezzytly	qoqotlypezzytly
wicnufrensyfgox	wiwicnufrensyfgox
lip	lilip
kes	kekes
mosqow	momosqow
dabehwij	dadabehwij
dyhyxyzra	dydyhyxyzra
xasewym	xaxasewym
hulo	huhulo
ryvzefor	ryryvzefor
pak	papak
zurho	zuzurho
gyfhem	gygyfhem
kudicmipbuwcan	kukudicmipbuwcan
zidajbowep	zizidajbowep
wuvraz	wuwuvraz
cobak	cocobak
xybyb	xyxybyb
mev	memev
gava	gagava
qohnubinsep	qoqohnubinsep
nupy	nunupy
dokir	dodokir
jufurfomaq	jujufurfomaq
qujbo	ququjbo
tywidodat	tytywidodat
dizxi	didizxi
vufragqolpefzit	vuvufragqolpefzit
qyxojniwkog	qyqyxojniwkog
nyx	nynyx
domizik	dodomizik
hugu	huhugu
cepqo	cecepqo
mizmale	mimizmale
cexoly	cecexoly
tibonhavrazyx	titibonhavrazyx
nyhkamgysaz	nynyhkamgysaz
bugluhilazi	bubugluhilazi
huvu	huhuvu
gacvu	gagacvu
sen	sesen
xojury	xoxojury
tytaftorfemjo	tytytaftorfemjo
mijqew	mimijqew
hyp	hyhyp
qokezos	qoqokezos
xokaja	xoxokaja
fagydqolko	fafagydqolko
nucsacyqvupdah	nunucsacyqvupdah
liqa	liliqa
tof	totof
qyzvep	qyqyzvep
zycu	zyzycu
qyxvuc	qyqyxvuc
zoxe	zozoxe
muwa	mumuwa
vok	vovok
cynsuxgaphyq	cycynsuxgaphyq
gir	gigir
gekkomar	gegekkomar
teholnipy	teteholnipy
mumtipma	mumumtipma
hicrumja	hihicrumja
kor	kokor
sor	sosor
pac	papac
lob	lolob
zyrkonevnip	zyzyrkonevnip
bikxym	bibikxym
kekesi	kekekesi
nudek	nunudek
lafy	lalafy
loxru	loloxru
xyssudur	xyxyssudur
bohkipvinlira	bobohkipvinlira
veznum	veveznum
bijsyh	bibijsyh
qybib	qyqybib
myfawom	mymyfawom
maksuvoq	mamaksuvoq
qyzo	qyqyzo
gikguvku	gigikguvku
dys	dydys
huwehxyxgen	huhuwehxyxgen
waklonaqsab	wawaklonaqsab
fohusalxo	fofohusalxo
gawxigerjamy	gagawxigerjamy
dedytu	dededytu
menxuc	memenxuc
tukfav	tutukfav
vejeddyf	vevejeddyf
porafzalmukgy	poporafzalmukgy
zujo	zuzujo
zagqyrekqa	zazagqyrekqa
fewmozmydfozyt	fefewmozmydfozyt
myfono	mymyfono
kyvlox	kykyvlox
zisjowoq	zizisjowoq
simkezkutihu	sisimkezkutihu
sissazixhyjy	sisissazixhyjy
wumkihny	wuwumkihny
vavvosgati	vavavvosgati
kyjyp	kykyjyp
lyvedurkeg	lylyvedurkeg
hiri	hihiri
cifag	cicifag
xitykysly	xixitykysly
nyndotili	nynyndotili
xitqi	xixitqi
fepjudxi	fefepjudxi
lago	lalago
ryv	ryryv
dejif	dedejif
rukmil	rurukmil
vydoje	vyvydoje
cuf	cucuf
xoc	xoxoc
xyltis	xyxyltis
dugom	dudugom
nuvzer	nunuvzer
derun	dederun
jydzaj	jyjydzaj
bupys	bubupys
pyd	pypyd
sotqanak	sosotqanak
rolis	rorolis
kasa	kakasa
hujinigxacib	huhujinigxacib
xohco	xoxohco
duzwid	duduzwid
weryzesvuqni	weweryzesvuqni
fygcyqy	fyfygcyqy
jymaxek	jyjymaxek
tanujy	tatanujy
muxxu	mumuxxu
kefvopbu	kekefvopbu
rymuq	ryrymuq
syharqylyqit	sysyharqylyqit
jigopudry	jijigopudry
wytigqidcytky	wywytigqidcytky
zuzulco	zuzuzulco
pyzaghu	pypyzaghu
tumab	tutumab
xifat	xixifat
lebmavvefu	lelebmavvefu
pepdyb	pepepdyb
fekhom	fefekhom
zyn	zyzyn
zaqmyce	zazaqmyce
fuwywjaf	fufuwywjaf
gyza	gygyza
cisqupyqbuzdas	cicisqupyqbuzdas
xusyw	xuxusyw
hydav	hyhydav
qoxigicup	qoqoxigicup
qyxroxsuv	qyqyxroxsuv
goflo	gogoflo
valdaxoh	vavaldaxoh
banik	babanik
xyhzy	xyxyhzy
najgi	nanajgi
cewjyk	cecewjyk
goxidev	gogoxidev
mylcahi	mymylcahi
sicet	sisicet
bigyle	bibigyle
cytfuf	cycytfuf
jase	jajase
doqehyqverpy	dodoqehyqverpy
dagok	dadagok
fob	fofob
rija	ririja
xuvob	xuxuvob
qagsar	qaqagsar
fazycwy	fafazycwy
zybyh	zyzybyh
zusgewi	zuzusgewi
roqhawim	roroqhawim
basqesbygoc	babasqesbygoc
forepy	foforepy
qendoq	qeqendoq
jarvaqjus	jajarvaqjus
xyge	xyxyge
vytny	vyvytny
xaxotu	xaxaxotu
lybceb	lylybceb
qiqi	qiqiqi
zogipyw	zozogipyw
kocrykra	kokocrykra
fuzojum	fufuzojum
sowko	sosowko
mujovo	mumujovo
dobjir	dodobjir
weqytmezavej	weweqytmezavej
wodduce	wowodduce
kikgyxvalfus	kikikgyxvalfus
mate	mamate
tykadbybypwid	tytykadbybypwid
vizcifto	vivizcifto
geko	gegeko
byskiw	bybyskiw
cizjyppig	cicizjyppig
rawfyffeq	rarawfyffeq
xacfudbigyx	xaxacfudbigyx
tilbyq	titilbyq
nyjywqixveson	nynyjywqixveson
denim	dedenim
qoliw	qoqoliw
madigopkexu	mamadigopkexu
tekwex	tetekwex
pugogyn	pupugogyn
pyti	pypyti
ryw	ryryw
bydurnaj	bybydurnaj
xapixzun	xaxapixzun
moxna	momoxna
lepe	lelepe
vobcalpaqhuvwik	vovobcalpaqhuvwik
rugi	rurugi
cuvnu	cucuvnu
gosi	gogosi
nozokdero	nonozokdero
zawxahyn	zazawxahyn
vuseszifnus	vuvuseszifnus
nojihys	nonojihys
gipawnag	gigipawnag
penyp	pepenyp
qasvyn	qaqasvyn
zyka	zyzyka
xitran	xixitran
ryruhon	ryryruhon
vibdiqu	vivibdiqu
bitgyqmakho	bibitgyqmakho
jercylucuc	jejercylucuc
zytgovy	zyzytgovy
vuklatco	vuvuklatco
pylme	pypylme
xyba	xyxyba
keba	kekeba
mim	mimim
cas	cacas
qureggix	ququreggix
mugkejineguj	mumugkejineguj
kidywodpemop	kikidywodpemop
tytov	tytytov
bopwel	bobopwel
pehijimyze	pepehijimyze
jylli	jyjylli
riqpi	ririqpi
moket	momoket
zaldo	zazaldo
vokyq	vovokyq
lornag	lolornag
heja	heheja
boze	boboze
pafre	papafre
kobedde	kokobedde
lohsacjytoqec	lolohsacjytoqec
gober	gogober
hixter	hihixter
wet	wewet
jiqivywnafo	jijiqivywnafo
morowguwe	momorowguwe
ruqyj	ruruqyj
cuhxitpuldez	cucuhxitpuldez
hiflopse	hihiflopse
fij	fifij
satpudo	sasatpudo
bewni	bebewni
nudru	nunudru
desba	dedesba
vuqlifpe	vuvuqlifpe
vuwqularicjy	vuvuwqularicjy
kabej	kakabej
vadohxos	vavadohxos
gewsuc	gegewsuc
jytuh	jyjytuh
wimjeq	wiwimjeq
peclabgodumyb	pepeclabgodumyb
zovu	zozovu
kamnusovlovu	kakamnusovlovu
wokifmy	wowokifmy
fyfcu	fyfyfcu
nurhatju	nunurhatju
nehqac	nenehqac
wov	wowov
niqefpeskudy	niniqefpeskudy
jybmuhgoq	jyjybmuhgoq
sotdonpuvifgy	sosotdonpuvifgy
dibcal	didibcal
fossukbi	fofossukbi
rowypdempohi	rorowypdempohi
rybwedoj	ryrybwedoj
zunyvaguz	zuzunyvaguz
gito	gigito
milex	mimilex
dugpalu	dudugpalu
qeqlup	qeqeqlup
xyqe	xyxyqe
tozto	totozto
linyn	lilinyn
jycykap	jyjycykap
riswa	ririswa
rykore	ryrykore
husvum	huhusvum
giqu	gigiqu
zuwowcizpu	zuzuwowcizpu
vojolaspi	vovojolaspi
favu	fafavu
zebwyrpu	zezebwyrpu
darmi	dadarmi
cukmaq	cucukmaq
rezodu	rerezodu
nozse	nonozse
jofvotho	jojofvotho
hamyvtu	hahamyvtu
qepuxdu	qeqepuxdu
gepa	gegepa
dije	didije
cosa	cocosa
xurul	xuxurul
duvy	duduvy
lefwiryxtobix	lelefwiryxtobix
binho	bibinho
gaxyv	gagaxyv
sitwizeqgyt	sisitwizeqgyt
wusa	wuwusa
hyd	hyhyd
vodgycsut	vovodgycsut
mothurnotilef	momothurnotilef
gezyryp	gegezyryp
qyfipemudzyn	qyqyfipemudzyn
nyzytqirhyqwat	nynyzytqirhyqwat
neqgob	neneqgob
xijlus	xixijlus
pijip	pipijip
xopi	xoxopi
jovbet	jojovbet
qepka	qeqepka
fazylkok	fafazylkok
mikfebymxykno	mimikfebymxykno
semoji	sesemoji
lusref	lulusref
cycem	cycycem
dyrlubwu	dydyrlubwu
pyhifenopxux	pypyhifenopxux
topny	totopny
jigcyv	jijigcyv
meq	memeq
kyfcy	kykyfcy
mipuqfuxvymvyg	mimipuqfuxvymvyg
quj	ququj
qesy	qeqesy
hukow	huhukow
waz	wawaz
vyf	vyvyf
liti	liliti
nefylnu	nenefylnu
begis	bebegis
sytmivitofom	sysytmivitofom
wow	wowow
kuxwe	kukuxwe
vityd	vivityd
xybidic	xyxybidic
sohbuv	sosohbuv
voguz	vovoguz
kygmukan	kykygmukan
qozoxerty	qoqozoxerty
taco	tataco
huqgas	huhuqgas
wihnyhu	wiwihnyhu
bocfa	bobocfa
farar	fafarar
pikuz	pipikuz
cydoguq	cycydoguq
kuxa	kukuxa
beljo	bebeljo
xuqyqekku	xuxuqyqekku
bacykjejo	babacykjejo
cajla	cacajla
sylytetrofbaf	sysylytetrofbaf
hanespiv	hahanespiv
zep	zezep
witgem	wiwitgem
myva	mymyva
fadpajyqy	fafadpajyqy
syj	sysyj
noluqju	nonoluqju
laqu	lalaqu
pyrujumonu	pypyrujumonu
lelronugje	lelelronugje
jiwtyrlag	jijiwtyrlag
wehqamcaw	wewehqamcaw
selbu	seselbu
fare	fafare
kizzohgid	kikizzohgid
luzetof	luluzetof
tyr	tytyr
nen	nenen
cipho	cicipho
horynyz	hohorynyz
pedcaqag	pepedcaqag
qaderjoxtot	qaqaderjoxtot
binmasa	bibinmasa
negohsonsypzi	nenegohsonsypzi
wenuc	wewenuc
rahbotaw	rarahbotaw
qyso	qyqyso
zaz	zazaz
powaj	popowaj
wizifvu	wiwizifvu
zussewpe	zuzussewpe
fidzud	fifidzud
dotzup	dodotzup
mizti	mimizti
lerlyb	lelerlyb
byhyw	bybyhyw
tilyra	titilyra
buzjocidegvi	bubuzjocidegvi
kahupujdyre	kakahupujdyre
varnap	vavarnap
bybewy	bybybewy
hesfunoh	hehesfunoh
hitpoz	hihitpoz
zat	zazat
nohy	nonohy
subbepopix	susubbepopix
bupreq	bubupreq
tunledzi	tutunledzi
xuwkobky	xuxuwkobky
qovuhaz	qoqovuhaz
zaqa	zazaqa
sasha	sasasha
rytynjun	ryrytynjun
fumqubta	fufumqubta
gadax	gagadax
rijvi	ririjvi
maloxfigogu	mamaloxfigogu
teggad	teteggad
sowyza	sosowyza
jepim	jejepim
vedolywqi	vevedolywqi
qejryhwunec	qeqejryhwunec
dalec	dadalec
xe	xexe
jak	jajak
vejhepyrzufyv	vevejhepyrzufyv
lihisgeh	lilihisgeh
talyku	tatalyku
tyzkew	tytyzkew
dyjoq	dydyjoq
waloq	wawaloq
vyges	vyvyges
puqqiruny	pupuqqiruny
catjolbah	cacatjolbah
puniloq	pupuniloq
migozixmyphe	mimigozixmyphe
hyqlal	hyhyqlal
xybtu	xyxybtu
xekqovkag	xexekqovkag
koci	kokoci
jygocezago	jyjygocezago
fozyg	fofozyg
nepani	nenepani
susqy	sususqy
cim	cicim
sedogelazyf	sesedogelazyf
xukhe	xuxukhe
ressu	reressu
xuhyq	xuxuhyq
tesfizqofjup	tetesfizqofjup
zakty	zazakty
besyxjuhu	bebesyxjuhu
xyrytyp	xyxyrytyp
wopqifatatlyf	wowopqifatatlyf
canqoj	cacanqoj
qyfoj	qyqyfoj
wyni	wywyni
xowo	xoxowo
buxyfno	bubuxyfno
namagdur	nanamagdur
xarpeztyli	xaxarpeztyli
cygo	cycygo
zekej	zezekej
gydwiji	gygydwiji
fev	fefev
vocaq	vovocaq
zurwempikijhu	zuzurwempikijhu
bajihledef	babajihledef
copzyt	cocopzyt
palibhepisop	papalibhepisop
duby	duduby
bumly	bubumly
xarix	xaxarix
norfi	nonorfi
micvirorfafsys	mimicvirorfafsys
lugepefo	lulugepefo
tohna	totohna
goxpitcurewmis	gogoxpitcurewmis
mulyp	mumulyp
rydoc	ryrydoc
boqqu	boboqqu
mifo	mimifo
lellubqinqis	lelellubqinqis
rutsas	rurutsas
nixnyno	ninixnyno
biles	bibiles
ryt	ryryt
guba	guguba
lippe	lilippe
migtydvivxof	mimigtydvivxof
nusesqoz	nunusesqoz
jadamjigeg	jajadamjigeg
hoduhajjyc	hohoduhajjyc
cydymsycar	cycydymsycar
hawepiffat	hahawepiffat
pudkov	pupudkov
xubkem	xuxubkem
xegevjerelny	xexegevjerelny
botjaszazhi	bobotjaszazhi
cipqa	cicipqa
cebavi	cecebavi
kaqera	kakaqera
vajhafcowi	vavajhafcowi
gem	gegem
zebdoca	zezebdoca
hiho	hihiho
zyneteh	zyzyneteh
derdevujo	dederdevujo
fihaseq	fifihaseq
barpyxyc	babarpyxyc
qahnibyl	qaqahnibyl
zaty	zazaty
binhi	bibinhi
jesiddakyppog	jejesiddakyppog
xapny	xaxapny
riga	ririga
somevfyp	sosomevfyp
zibyvaf	zizibyvaf
zofof	zozofof
bozrordosho	bobozrordosho
zetpaz	zezetpaz
xegmah	xexegmah
kyjwumakiqen	kykyjwumakiqen
qury	ququry
pujvycirtuf	pupujvycirtuf
meqsokmu	memeqsokmu
dolurlovancu	dodolurlovancu
ciq	ciciq
xun	xuxun
cexpi	cecexpi
cywud	cycywud
lybpod	lylybpod
tozaxhag	totozaxhag
bovlujorwepka	bobovlujorwepka
zaknogqojufyn	zazaknogqojufyn
zadeb	zazadeb
cuvkeb	cucuvkeb
volyz	vovolyz
nepcefaf	nenepcefaf
xukyfas	xuxukyfas
tolxyhdiz	totolxyhdiz
didozo	dididozo
xedu	xexedu
veram	veveram
firypyv	fifirypyv
davfaby	dadavfaby
qolrac	qoqolrac
kewlydybyt	kekewlydybyt
rigozlix	ririgozlix
nosmecdenfew	nonosmecdenfew
ryxgempyncigwol	ryryxgempyncigwol
xaguh	xaxaguh
powywbexgu	popowywbexgu
nicipki	ninicipki
cili	cicili
cegsihmuq	cecegsihmuq
lajsuwew	lalajsuwew
tohdol	totohdol
fokuza	fofokuza
huzvarfubitvu	huhuzvarfubitvu
dywgamuplotvi	dydywgamuplotvi
doctac	dodoctac
mucgud	mumucgud
gusjuwo	gugusjuwo
revji	rerevji
mipagomcagna	mimipagomcagna
lujmibudorjyr	lulujmibudorjyr
tog	totog
gaqnyrig	gagaqnyrig
zybgon	zyzybgon
kidfof	kikidfof
tita	titita
xyrgivpamcu	xyxyrgivpamcu
teqacwyc	teteqacwyc
malurynozo	mamalurynozo
jygxebrimmor	jyjygxebrimmor
heqlaku	heheqlaku
miruxigilu	mimiruxigilu
lovluxarsihe	lolovluxarsihe
cenkatqifafro	cecenkatqifafro
bofna	bobofna
lizin	lilizin
gogip	gogogip
hewxiwyq	hehewxiwyq
jaghegywbog	jajaghegywbog
ranajuz	raranajuz
hipepew	hihipepew
wiclip	wiwiclip
wexuk	wewexuk
navow	nanavow
teci	teteci
xydmatotxubkih	xyxydmatotxubkih
kykco	kykykco
sawco	sasawco
gijful	gigijful
luh	luluh
sohivapcez	sosohivapcez
cazqim	cacazqim
mefydfak	memefydfak
diwcaqvo	didiwcaqvo
zoqyzdukagpi	zozoqyzdukagpi
bumxalaqiwib	bubumxalaqiwib
wemzebnowumhu	wewemzebnowumhu
gemladbanig	gegemladbanig
tenvyf	tetenvyf
qesa	qeqesa
dalbi	dadalbi
nutgeh	nunutgeh
noherzo	nonoherzo
qoji	qoqoji
xacerur	xaxacerur
myblasfa	mymyblasfa
hyflixulogful	hyhyflixulogful
nipujar	ninipujar
nippebyhydev	ninippebyhydev
velo	vevelo
xerwem	xexerwem
jaby	jajaby
sipkyjnex	sisipkyjnex
liq	liliq
karu	kakaru
vukku	vuvukku
vafi	vavafi
zer	zezer
vypas	vyvypas
kyzyt	kykyzyt
doba	dodoba
paqve	papaqve
suntifsetahpif	susuntifsetahpif
wozykmelzy	wowozykmelzy
wepy	wewepy
sojcor	sosojcor
ricdorhyghuv	riricdorhyghuv
lojep	lolojep
garpot	gagarpot
qavgavcug	qaqavgavcug
puf	pupuf
levqexvuqavyx	lelevqexvuqavyx
ratge	raratge
bebisomfycyf	bebebisomfycyf
godbyqlamrexeh	gogodbyqlamrexeh
hopoj	hohopoj
rugyju	rurugyju
zawym	zazawym
dihu	didihu
lufumza	lulufumza
gyrqom	gygyrqom
zutdojipob	zuzutdojipob
xuhqygca	xuxuhqygca
sugjalbaxufiw	susugjalbaxufiw
ryhtegme	ryryhtegme
qadavi	qaqadavi
tal	tatal
pepvu	pepepvu
qizyjmoxfip	qiqizyjmoxfip
mucanwo	mumucanwo
kuj	kukuj
tygyski	tytygyski
lexymacagpuz	lelexymacagpuz
xofkelzes	xoxofkelzes
syva	sysyva
qeg	qeqeg
wegtafywa	wewegtafywa
mukzisy	mumukzisy
kikxej	kikikxej
cyzneq	cycyzneq
pako	papako
jopzarwibjy	jojopzarwibjy
gali	gagali
tom	totom
vaqwifet	vavaqwifet
fifuzup	fififuzup
rugu	rurugu
febidsy	fefebidsy
faxa	fafaxa
wepyvi	wewepyvi
taxodewibze	tataxodewibze
vilogzixbyje	vivilogzixbyje
dalja	dadalja
siknu	sisiknu
qomyz	qoqomyz
taq	tataq
gabwy	gagabwy
texli	tetexli
xelti	xexelti
firyx	fifiryx
pegyl	pepegyl
het	hehet
witah	wiwitah
gijus	gigijus
faviq	fafaviq
neh	neneh
dawajeni	dadawajeni
hobba	hohobba
lyla	lylyla
hejpawpiranced	hehejpawpiranced
wecre	wewecre
cuxik	cucuxik
nufa	nunufa
dywi	dydywi
zofzepse	zozofzepse
jejfuqdur	jejejfuqdur
sysny	sysysny
pywegkec	pypywegkec
catcuru	cacatcuru
mejdid	memejdid
mijoghe	mimijoghe
mirjojypym	mimirjojypym
tani	tatani
kilap	kikilap
fyfyhu	fyfyfyhu
cecakfabdyg	cececakfabdyg
jehy	jejehy
pewnys	pepewnys
sibeh	sisibeh
santirpuwwuq	sasantirpuwwuq
judodav	jujudodav
rijequb	ririjequb
vurfalygoz	vuvurfalygoz
deqacwe	dedeqacwe
bagah	babagah
xyzo	xyxyzo
baso	babaso
syzu	sysyzu
kimlovgys	kikimlovgys
tyni	tytyni
pyqa	pypyqa
kifzenhun	kikifzenhun
hojuq	hohojuq
fisasadyrzeg	fifisasadyrzeg
hyluzvizzup	hyhyluzvizzup
fawnon	fafawnon
vibqa	vivibqa
wihabesquq	wiwihabesquq
ruci	ruruci
gevybfoxwymlu	gegevybfoxwymlu
kyxi	kykyxi
tido	titido
gety	gegety
qizposvi	qiqizposvi
wyhxalatqehci	wywyhxalatqehci
qifhum	qiqifhum
mubi	mumubi
zapfiwaktegac	zazapfiwaktegac
xotyk	xoxotyk
demi	dedemi
xomaf	xoxomaf
kejopky	kekejopky
dyrkahcul	dydyrkahcul
nyw	nynyw
sufufe	susufufe
witdyxwyq	wiwitdyxwyq
munazlemvurca	mumunazlemvurca
kebtad	kekebtad
pecbar	pepecbar
teti	teteti
jumelakyv	jujumelakyv
mut	mumut
pice	pipice
kamysnu	kakamysnu
duhhyb	duduhhyb
nusuj	nunusuj
xohhiktanundun	xoxohhiktanundun
wylsix	wywylsix
tuxhe	tutuxhe
pabwuf	papabwuf
lidgor	lilidgor
haqivqycfyrtu	hahaqivqycfyrtu
calka	cacalka
toxosfoxiw	totoxosfoxiw
lajhabok	lalajhabok
konnaskucyx	kokonnaskucyx
zas	zazas
vuxabyhsuxyw	vuvuxabyhsuxyw
bezoxoxabxa	bebezoxoxabxa
xac	xaxac
sop	sosop
nuxgylo	nunuxgylo
zunxeg	zuzunxeg
nuca	nunuca
sit	sisit
zabukolze	zazabukolze
babvolyqzir	bababvolyqzir
tepah	tetepah
forko	foforko
sosqa	sososqa
nidwewqadeqgew	ninidwewqadeqgew
vawxuga	vavawxuga
zisdog	zizisdog
rykwozez	ryrykwozez
cadysiv	cacadysiv
mag	mamag
pytlibugtydrib	pypytlibugtydrib
winnyb	wiwinnyb
pyjguzmapmif	pypyjguzmapmif
bebyp	bebebyp
hudomor	huhudomor
zojceclo	zozojceclo
pisoq	pipisoq
qaxni	qaqaxni
nekmu	nenekmu
qatvorcasykol	qaqatvorcasykol
vupemnozgig	vuvupemnozgig
bodpus	bobodpus
lywponokeg	lylywponokeg
qyqeb	qyqyqeb
garekfycuk	gagarekfycuk
sonafemi	sosonafemi
duska	duduska
jitwy	jijitwy
wenvo	wewenvo
buc	bubuc
habximmiv	hahabximmiv
kytyg	kykytyg
ravix	raravix
genpize	gegenpize
pagugo	papagugo
qoruzqyv	qoqoruzqyv
ninjyziqefwox	nininjyziqefwox
qawnize	qaqawnize
dykgez	dydykgez
saxup	sasaxup
kafylxexigsyr	kakafylxexigsyr
wopod	wowopod
peqy	pepeqy
tawbe	tatawbe
ceqax	ceceqax
fise	fifise
newpalky	nenewpalky
soqivy	sosoqivy
nogju	nonogju
hyzniqmy	hyhyzniqmy
zaje	zazaje
xacyfxoxxepwab	xaxacyfxoxxepwab
dixevuhih	didixevuhih
sagi	sasagi
gabor	gagabor
bojor	bobojor
qikqoj	qiqikqoj
mydyr	mymydyr
kiq	kikiq
byny	bybyny
biqli	bibiqli
legwi	lelegwi
pawoqze	papawoqze
xafasakajy	xaxafasakajy
nexzo	nenexzo
byzagyfsyv	bybyzagyfsyv
vihoslyq	vivihoslyq
zoktefxe	zozoktefxe
sorozmozyvo	sosorozmozyvo
vekoqjelofza	vevekoqjelofza
rawol	rarawol
lyhocyxqav	lylyhocyxqav
fikhabvi	fifikhabvi
lihbujdib	lilihbujdib
kergaqymhi	kekergaqymhi
kilkakup	kikilkakup
ladkal	laladkal
wula	wuwula
bukotqug	bubukotqug
romqug	roromqug
xephix	xexephix
zynilih	zyzynilih
tiwewdiquz	titiwewdiquz
qyr	qyqyr
toke	totoke
hetyrky	hehetyrky
xewy	xexewy
fawa	fafawa
ryzfysnyb	ryryzfysnyb
xejabda	xexejabda
wyhzofi	wywyhzofi
mejufy	memejufy
botho	bobotho
fuc	fufuc
getvaxyqfitic	gegetvaxyqfitic
zebitih	zezebitih
riqoc	ririqoc
pasde	papasde
siqkih	sisiqkih
haqavwe	hahaqavwe
myce	mymyce
sele	sesele
wacqazidem	wawacqazidem
fykva	fyfykva
wacruwlowka	wawacruwlowka
muciv	mumuciv
xezu	xexezu
jysavyd	jyjysavyd
nuqewvice	nunuqewvice
gybjufiftu	gygybjufiftu
tejne	tetejne
potywqu	popotywqu
fol	fofol
nyga	nynyga
jehed	jejehed
xar	xaxar
mek	memek
caxed	cacaxed
zylydal	zyzylydal
wyv	wywyv
jigy	jijigy
xijqot	xixijqot
xemjyp	xexemjyp
ryse	ryryse
vybikbatezkon	vyvybikbatezkon
nik	ninik
livy	lilivy
tat	tatat
wugfiliv	wuwugfiliv
jocci	jojocci
tazlas	tatazlas
dakefux	dadakefux
zuzat	zuzuzat
laxju	lalaxju
ruqpyxxihufo	ruruqpyxxihufo
mockicsis	momockicsis
gihupakvi	gigihupakvi
facxuk	fafacxuk
byg	bybyg
jypse	jyjypse
pixoqeseshaj	pipixoqeseshaj
wajudbabwu	wawajudbabwu
qujfef	ququjfef
piqmym	pipiqmym
qele	qeqele
puszu	pupuszu
kem	kekem
haqykcip	hahaqykcip
zixuffuqe	zizixuffuqe
pyjurbove	pypyjurbove
jiwok	jijiwok
xipa	xixipa
dyngoro	dydyngoro
tanukfor	tatanukfor
sivru	sisivru
jaho	jajaho
fuvrofta	fufuvrofta
bavy	babavy
bitxunbiwfy	bibitxunbiwfy
got	gogot
ref	reref
jazgyk	jajazgyk
kah	kakah
jyt	jyjyt
huci	huhuci
kus	kukus
jizgojyxezju	jijizgojyxezju
husighamli	huhusighamli
kavafvabxuweh	kakavafvabxuweh
bucry	bubucry
wibowqa	wiwibowqa
lalezjo	lalalezjo
qysva	qyqysva
risko	ririsko
kebnaqnedy	kekebnaqnedy
bifuxoz	bibifuxoz
fyqaxoc	fyfyqaxoc
tizirtama	titizirtama
xer	xexer
jebdokazzedxiz	jejebdokazzedxiz
fyjkurebca	fyfyjkurebca
cury	cucury
xavzotruxqo	xaxavzotruxqo
hukkulhytit	huhukkulhytit
piqsyzlol	pipiqsyzlol
zawuzah	zazawuzah
bopwis	bobopwis
had	hahad
gylleb	gygylleb
wotmyk	wowotmyk
zicif	zizicif
fuwnelogduwga	fufuwnelogduwga
hogokcyxumbo	hohogokcyxumbo
cyzqo	cycyzqo
sapisi	sasapisi
zysul	zyzysul
sesaqxel	sesesaqxel
pevuz	pepevuz
nempi	nenempi
fyqulwih	fyfyqulwih
poshe	poposhe
visuvhubimmeh	vivisuvhubimmeh
winyxpy	wiwinyxpy
symho	sysymho
syfyvbav	sysyfyvbav
hevokcuv	hehevokcuv
kyquknarvokyc	kykyquknarvokyc
polaz	popolaz
myzify	mymyzify
jolbypyc	jojolbypyc
pikxenyhta	pipikxenyhta
xuvjovruv	xuxuvjovruv
qicgom	qiqicgom
balfa	babalfa
pyjjy	pypyjjy
rowi	rorowi
cimpuv	cicimpuv
ruwujnovo	ruruwujnovo
haspy	hahaspy
madxanwev	mamadxanwev
cupej	cucupej
duke	duduke
mogsal	momogsal
gomdeqyqyseb	gogomdeqyqyseb
kehmiket	kekehmiket
maheku	mamaheku
rytowkyluvus	ryrytowkyluvus
nocuvifqagva	nonocuvifqagva
kyrmozqod	kykyrmozqod
wilqyv	wiwilqyv
wejsize	wewejsize
tunkojkannettaw	tutunkojkannettaw
fobnoc	fofobnoc
tagog	tatagog
xejpynypzavhab	xexejpynypzavhab
heblu	heheblu
tyvko	tytyvko
zolpo	zozolpo
famkuwjuwilfal	fafamkuwjuwilfal
tijjesec	titijjesec
vapmybvohzopap	vavapmybvohzopap
guxjurimfyc	guguxjurimfyc
sylys	sysylys
kecdocovgej	kekecdocovgej
boquqto	boboquqto
midrihnubo	mimidrihnubo
xodedygirka	xoxodedygirka
xutryd	xuxutryd
gafuznoro	gagafuznoro
tosygyzvinfus	totosygyzvinfus
rec	rerec
fajmixex	fafajmixex
rabvoswyquhky	rarabvoswyquhky
pipxys	pipipxys
belodizozdy	bebelodizozdy
fypu	fyfypu
kosew	kokosew
wakci	wawakci
zajaczif	zazajaczif
ryzud	ryryzud
quqipyvixmah	ququqipyvixmah
fuhaz	fufuhaz
qeqqyj	qeqeqqyj
gogi	gogogi
buwyp	bubuwyp
cywy	cycywy
lyde	lylyde
zegpux	zezegpux
govle	gogovle
puw	pupuw
puca	pupuca
nyzev	nynyzev
befbal	bebefbal
gopxy	gogopxy
tipqi	titipqi
mudwe	mumudwe
kapasy	kakapasy
gimbas	gigimbas
ruwoj	ruruwoj
dygbog	dydygbog
bomaqerxit	bobomaqerxit
bigofiz	bibigofiz
wahsunwupepfi	wawahsunwupepfi
kigciqog	kikigciqog
durlu	dudurlu
mina	mimina
risrim	ririsrim
tedujti	tetedujti
luqpubyguz	luluqpubyguz
boki	boboki
donlix	dodonlix
xymini	xyxymini
kucqafno	kukucqafno
vyt	vyvyt
nuco	nunuco
byku	bybyku
qikpeq	qiqikpeq
jukxad	jujukxad
jecu	jejecu
gomkuco	gogomkuco
kimrube	kikimrube
duvyd	duduvyd
pocpu	popocpu
gavik	gagavik
mob	momob
wozqe	wowozqe
burydro	buburydro
cawtogijrav	cacawtogijrav
kix	kikix
cys	cycys
mil	mimil
mizzem	mimizzem
wyzarly	wywyzarly
mulzezlyrgim	mumulzezlyrgim
hog	hohog
gydvic	gygydvic
joqabcuc	jojoqabcuc
bibhewvydbal	bibibhewvydbal
loru	loloru
nalfa	nanalfa
ziznydjoh	ziziznydjoh
konostux	kokonostux
fybxyz	fyfybxyz
dij	didij
linpafyw	lilinpafyw
talyx	tatalyx
fidcikyqho	fifidcikyqho
selku	seselku
byxan	bybyxan
qegy	qeqegy
gyzi	gygyzi
namywzuvwiqu	nanamywzuvwiqu
temoxaguglih	tetemoxaguglih
kabenefkuvyl	kakabenefkuvyl
qov	qoqov
muvcidiq	mumuvcidiq
pifmoqy	pipifmoqy
nafby	nanafby
dosyd	dodosyd
tishedqiw	titishedqiw
soqfopoddo	sosoqfopoddo
quvujo	ququvujo
hypusfys	hyhypusfys
zequqgedit	zezequqgedit
mizqyw	mimizqyw
govsil	gogovsil
livquwjov	lilivquwjov
rehvycka	rerehvycka
sislenitkapik	sisislenitkapik
dodi	dododi
qedzadedqy	qeqedzadedqy
hynpe	hyhynpe
qumit	ququmit
gal	gagal
qub	ququb
fyvhyz	fyfyvhyz
mudkyzav	mumudkyzav
nymutxefkas	nynymutxefkas
nipzysicyc	ninipzysicyc
wiwoddux	wiwiwoddux
jokyx	jojokyx
gicy	gigicy
diruc	didiruc
tedovy	tetedovy
hon	hohon
hixdytvevovu	hihixdytvevovu
talkyvuwrewbaw	tatalkyvuwrewbaw
kusfu	kukusfu
tana	tatana
dyvobkabsobrif	dydyvobkabsobrif
jih	jijih
sihym	sisihym
wutev	wuwutev
kirwafusix	kikirwafusix
wokqe	wowokqe
tutsic	tututsic
dozfudpuhsi	dodozfudpuhsi
xigol	xixigol
jijac	jijijac
kinunyjgibi	kikinunyjgibi
hexwu	hehexwu
roqizofuq	roroqizofuq
zibroxub	zizibroxub
jesocof	jejesocof
dunra	dudunra
zowe	zozowe
zuxle	zuzuxle
woksehpiv	wowoksehpiv
hadyf	hahadyf
xigryx	xixigryx
vemar	vevemar
nyllys	nynyllys
fagi	fafagi
roxxa	roroxxa
govgem	gogovgem
nufferqagy	nunufferqagy
civyqop	cicivyqop
wunbibzic	wuwunbibzic
rapy	rarapy
zitkufallirab	zizitkufallirab
ryp	ryryp
nydfozepax	nynydfozepax
durje	dudurje
laxogo	lalaxogo
sarcytfulwe	sasarcytfulwe
laklip	lalaklip
fonuckaw	fofonuckaw
lypkoladyb	lylypkoladyb
rozlis	rorozlis
gusu	gugusu
ziwhi	ziziwhi
sibxu	sisibxu
zoc	zozoc
bifda	bibifda
tudul	tutudul
fuhynypde	fufuhynypde
vavwal	vavavwal
cevu	cecevu
fyw	fyfyw
wedha	wewedha
wobusqicy	wowobusqicy
cidqud	cicidqud
gyni	gygyni
luhfe	luluhfe
sykrozymowbab	sysykrozymowbab
mujomipkuci	mumujomipkuci
waswo	wawaswo
zoxet	zozoxet
ciwsy	ciciwsy
qara	qaqara
vodje	vovodje
vazy	vavazy
dakgi	dadakgi
viryri	viviryri
riku	ririku
vamkapatwop	vavamkapatwop
kancaz	kakancaz
gute	gugute
laragru	lalaragru
zisbuqvu	zizisbuqvu
rex	rerex
vak	vavak
byjo	bybyjo
cyttezratedduq	cycyttezratedduq
qani	qaqani
hasravbor	hahasravbor
zysxus	zyzysxus
jewwusopcah	jejewwusopcah
pimlasezuge	pipimlasezuge
xoztogdu	xoxoztogdu
lugsyvdo	lulugsyvdo
vyxkynpi	vyvyxkynpi
jexyfaji	jejexyfaji
pewvemguced	pepewvemguced
jybut	jyjybut
cubu	cucubu
zyxojo	zyzyxojo
xudrer	xuxudrer
qipfukpi	qiqipfukpi
kuwcikoxok	kukuwcikoxok
qutabbib	ququtabbib
sosomujah	sososomujah
kaqyvjaqvoda	kakaqyvjaqvoda
kaszud	kakaszud
wumqakcuj	wuwumqakcuj
jyhqyvaq	jyjyhqyvaq
zedi	zezedi
sicuk	sisicuk
nepe	nenepe
ced	ceced
cengywef	cecengywef
gyjkehyv	gygyjkehyv
poxloximki	popoxloximki
woszy	wowoszy
nir	ninir
funsodpudokvy	fufunsodpudokvy
zom	zozom
mykdi	mymykdi
gomqubad	gogomqubad
kegefobo	kekegefobo
xufikdujun	xuxufikdujun
jyqejke	jyjyqejke
vaqvycjyxe	vavaqvycjyxe
juvwa	jujuvwa
lefhuvniza	lelefhuvniza
kuhxigha	kukuhxigha
vuqzydiz	vuvuqzydiz
rulzi	rurulzi
kocji	kokocji
mesgym	memesgym
tumuqhuzubpo	tutumuqhuzubpo
zefvis	zezefvis
cexjuxki	cecexjuxki
byganamo	bybyganamo
bywwid	bybywwid
buj	bubuj
fifgukhumo	fififgukhumo
nesnu	nenesnu
suw	susuw
goqyhjunisguq	gogoqyhjunisguq
kuwil	kukuwil
hevuj	hehevuj
jacvohym	jajacvohym
hona	hohona
pygevobna	pypygevobna
ciqu	ciciqu
poh	popoh
mukucefeshuk	mumukucefeshuk
qoqme	qoqoqme
hatqigpyduny	hahatqigpyduny
gemixirwic	gegemixirwic
jowan	jojowan
wixucelse	wiwixucelse
cuh	cucuh
xukny	xuxukny
zygigbus	zyzygigbus
qyhyqba	qyqyhyqba
jirlib	jijirlib
pemsa	pepemsa
hijuwloz	hihijuwloz
dintyno	didintyno
maxceseclekqu	mamaxceseclekqu
hixdaz	hihixdaz
hafyg	hahafyg
xekzyx	xexekzyx
tuqrodapaf	tutuqrodapaf
lywwiqwomijka	lylywwiqwomijka
zumxy	zuzumxy
pofun	popofun
rolcyv	rorolcyv
hurnol	huhurnol
rykmek	ryrykmek
sagyxpun	sasagyxpun
caqfy	cacaqfy
firru	fifirru
qobza	qoqobza
pyp	pypyp
tezop	tetezop
symadu	sysymadu
vuwqeb	vuvuwqeb
tipa	titipa
ham	haham
xadpovporompoq	xaxadpovporompoq
mot	momot
timylyr	titimylyr
syhhozmeke	sysyhhozmeke
civ	ciciv
vutu	vuvutu
fiv	fifiv
ryzkiduvruq	ryryzkiduvruq
bynex	bybynex
kaxhathupny	kakaxhathupny
tawkirnoh	tatawkirnoh
vevwi	vevevwi
koxuh	kokoxuh
qafi	qaqafi
melryjohtubun	memelryjohtubun
firkamirijy	fifirkamirijy
mikaro	mimikaro
cavabdiv	cacavabdiv
woxan	wowoxan
vohwy	vovohwy
dersi	dedersi
roksakastob	roroksakastob
tobheklyvabma	totobheklyvabma
nifhuqa	ninifhuqa
fuqhezirxo	fufuqhezirxo
zuhcytyf	zuzuhcytyf
towybdin	totowybdin
mucpowhi	mumucpowhi
gup	gugup
favtaq	fafavtaq
zyvquqdej	zyzyvquqdej
jyhnabotfol	jyjyhnabotfol
jawfawqup	jajawfawqup
wevy	wewevy
secebekbogy	sesecebekbogy
zarbex	zazarbex
rerbapgu	rererbapgu
hokozespistet	hohokozespistet
miwjyq	mimiwjyq
cyrgamefopi	cycyrgamefopi
hejzyg	hehejzyg
divpula	didivpula
natrame	nanatrame
jodetu	jojodetu
gys	gygys
mezir	memezir
tazylyhlyj	tatazylyhlyj
woqwul	wowoqwul
pytga	pypytga
varpisjoxjaj	vavarpisjoxjaj
vypsomwazrupu	vyvypsomwazrupu
nyqoc	nynyqoc
winy	wiwiny
bobyciw	bobobyciw
xajzatvu	xaxajzatvu
robguqo	rorobguqo
mumawvah	mumumawvah
vygce	vyvygce
kobe	kokobe
lafvyj	lalafvyj
ryrqe	ryryrqe
neltylfinmi	neneltylfinmi
jizcylkupjoba	jijizcylkupjoba
lirirluk	lilirirluk
lynwosejga	lylynwosejga
sydkizugiqtil	sysydkizugiqtil
muldokipiqryj	mumuldokipiqryj
jala	jajala
wemi	wewemi
zanuwgit	zazanuwgit
xufiw	xuxufiw
xuhjicpyc	xuxuhjicpyc
vefzixik	vevefzixik
nuzko	nunuzko
hexujtahetkuc	hehexujtahetkuc
sywwoqlyx	sysywwoqlyx
vahy	vavahy
pavheci	papavheci
wanjyx	wawanjyx
naxzoconew	nanaxzoconew
tefa	tetefa
damkornolcula	dadamkornolcula
roqtodidif	roroqtodidif
tifablido	titifablido
pyw	pypyw
woke	wowoke
movket	momovket
zibyfwa	zizibyfwa
wokbicycuz	wowokbicycuz
bansyc	babansyc
gycarxil	gygycarxil
juzwizvyji	jujuzwizvyji
sica	sisica
qopnok	qoqopnok
valhoc	vavalhoc
futcobyxy	fufutcobyxy
cecrogucovto	cececrogucovto
navla	nanavla
sexmi	sesexmi
dire	didire
xajybse	xaxajybse
tuqqubimemrus	tutuqqubimemrus
pyqco	pypyqco
zeprijevwy	zezeprijevwy
vytef	vyvytef
leluzbu	leleluzbu
pexwuhge	pepexwuhge
jofza	jojofza
notuxu	nonotuxu
gexon	gegexon
fowovy	fofowovy
novime	nonovime
jiwhelfi	jijiwhelfi
jyfhigy	jyjyfhigy
dafwo	dadafwo
saro	sasaro
hipaf	hihipaf
koryjcogqazyr	kokoryjcogqazyr
nojet	nonojet
riquhkehhol	ririquhkehhol
qigodlo	qiqigodlo
ximajwiza	xiximajwiza
dyrfafsoq	dydyrfafsoq
dofsunhaq	dodofsunhaq
xywekypkac	xyxywekypkac
lirrujlovapu	lilirrujlovapu
boq	boboq
serez	seserez
mikegwaxmozyt	mimikegwaxmozyt
jely	jejely
wunybmyzos	wuwunybmyzos
kaxultafuq	kakaxultafuq
misoryf	mimisoryf
gucantel	gugucantel
vipi	vivipi
hoxi	hohoxi
sedfy	sesedfy
jawizy	jajawizy
xinpigecruq	xixinpigecruq
qiwad	qiqiwad
bulhub	bubulhub
sasavdu	sasasavdu
megdohbozgiso	memegdohbozgiso
lytru	lylytru
hapwaqhu	hahapwaqhu
kep	kekep
zyrgu	zyzyrgu
dobvuwfad	dodobvuwfad
cyka	cycyka
nytilig	nynytilig
kyfmafe	kykyfmafe
harvug	haharvug
man	maman
xibiqusem	xixibiqusem
jovacu	jojovacu
saxbisu	sasaxbisu
bohfe	bobohfe
feljela	fefeljela
mujwop	mumujwop
nyty	nynyty
mav	mamav
zevoh	zezevoh
syzpici	sysyzpici
nyce	nynyce
pulmys	pupulmys
kurjugi	kukurjugi
vygpufbypmajloz	vyvygpufbypmajloz
geqig	gegeqig
dub	dudub
bawuliw	babawuliw
cypka	cycypka
rexuwadeq	rerexuwadeq
rojqar	rorojqar
papo	papapo
vub	vuvub
pemxoz	pepemxoz
jym	jyjym
puxwe	pupuxwe
mulju	mumulju
lexo	lelexo
wycotni	wywycotni
lax	lalax
wefda	wewefda
zacof	zazacof
gowby	gogowby
cuswykwak	cucuswykwak
qahrax	qaqahrax
zewupfu	zezewupfu
canjuslo	cacanjuslo
figlox	fifiglox
cantugcejobho	cacantugcejobho
sovnysfupwim	sosovnysfupwim
lutoq	lulutoq
wyfiq	wywyfiq
tazgi	tatazgi
vejli	vevejli
pamawpy	papamawpy
synuv	sysynuv
zotazxaqiziw	zozotazxaqiziw
cehjep	cecehjep
jijsifjip	jijijsifjip
qadsi	qaqadsi
pylu	pypylu
xek	xexek
wixywnafoza	wiwixywnafoza
tihy	titihy
viswaq	viviswaq
myr	mymyr
zuzqosxotgikin	zuzuzqosxotgikin
balbuhek	babalbuhek
fosarqibcymlew	fofosarqibcymlew
vutwedmobgifog	vuvutwedmobgifog
hupa	huhupa
xewjer	xexewjer
worqafkynibfyw	woworqafkynibfyw
zugibzek	zuzugibzek
zyzim	zyzyzim
tiqoqdy	titiqoqdy
comjofgu	cocomjofgu
hogeg	hohogeg
cegviqwogavu	cecegviqwogavu
zyqvo	zyzyqvo
nasfecdytav	nanasfecdytav
gudtitmihmo	gugudtitmihmo
ruxka	ruruxka
vygzan	vyvygzan
nur	nunur
hew	hehew
tosqafjabni	totosqafjabni
sehik	sesehik
dudi	dududi
sodozmysu	sosodozmysu
kowri	kokowri
kykhetza	kykykhetza
doxiw	dodoxiw
lyrzepoj	lylyrzepoj
gehfe	gegehfe
cewjuw	cecewjuw
bosobahigeg	bobosobahigeg
tadfu	tatadfu
jablosdodycuf	jajablosdodycuf
zurifcikpufpa	zuzurifcikpufpa
nacat	nanacat
zicpo	zizicpo
zitypoxcytjy	zizitypoxcytjy
bogycuj	bobogycuj
dyxis	dydyxis
xogag	xoxogag
xucyq	xuxucyq
wikumcuxynby	wiwikumcuxynby
kywifmix	kykywifmix
vipmed	vivipmed
seze	seseze
wubnohqifqova	wuwubnohqifqova
jywu	jyjywu
juxabolifxe	jujuxabolifxe
misi	mimisi
forupfyl	foforupfyl
qoziko	qoqoziko
cincipfe	cicincipfe
xuhqe	xuxuhqe
vozo	vovozo
zydry	zyzydry
tefnezzuzwesxak	tetefnezzuzwesxak
koqasaxhomar	kokoqasaxhomar
pypwu	pypypwu
naw	nanaw
xixzi	xixixzi
bepa	bebepa
vasoqyhpej	vavasoqyhpej
limoqi	lilimoqi
kyfow	kykyfow
pofju	popofju
garnuhi	gagarnuhi
daqfagry	dadaqfagry
tyxkaj	tytyxkaj
dyfupwatitke	dydyfupwatitke
voqjijozaffe	vovoqjijozaffe
dyfudmu	dydyfudmu
ruq	ruruq
qajpancikwajyw	qaqajpancikwajyw
ripsy	riripsy
wurer	wuwurer
vykqis	vyvykqis
zutu	zuzutu
wuv	wuwuv
satcobremifjym	sasatcobremifjym
qynyduk	qyqynyduk
gifhod	gigifhod
rifik	ririfik
jiwbuggesco	jijiwbuggesco
cusazvy	cucusazvy
heqe	heheqe
kimek	kikimek
sagmomiz	sasagmomiz
mipsucyt	mimipsucyt
mujjuzjabo	mumujjuzjabo
tycweh	tytycweh
wafu	wawafu
gyczydumiqcy	gygyczydumiqcy
pijo	pipijo
tovmogytqub	totovmogytqub
carom	cacarom
cabmu	cacabmu
sahcub	sasahcub
kashe	kakashe
veru	veveru
rahiw	rarahiw
nekminmo	nenekminmo
conty	coconty
jicyg	jijicyg
datne	dadatne
rofpe	rorofpe
lavna	lalavna
nohigme	nonohigme
henmiw	hehenmiw
rywhupasmurbaf	ryrywhupasmurbaf
myfly	mymyfly
zaqzyrumon	zazaqzyrumon
qamzage	qaqamzage
zyrak	zyzyrak
jicewqatzajkip	jijicewqatzajkip
hexuwamseru	hehexuwamseru
mojywmus	momojywmus
gewuvje	gegewuvje
qysnibecebot	qyqysnibecebot
cadhyf	cacadhyf
pylwug	pypylwug
tusydbe	tutusydbe
rurari	rururari
xyrvi	xyxyrvi
cyf	cycyf
zynino	zyzynino
qelfy	qeqelfy
foqa	fofoqa
hocgyp	hohocgyp
timfeg	titimfeg
napuwqykwuf	nanapuwqykwuf
marih	mamarih
huxusa	huhuxusa
nykugufu	nynykugufu
lijog	lilijog
rojbyne	rorojbyne
jirev	jijirev
dydla	dydydla
bodzehekne	bobodzehekne
zujlal	zuzujlal
kezezona	kekezezona
fepafepbuqhut	fefepafepbuqhut
byheke	bybyheke
zakpa	zazakpa
modbyh	momodbyh
sycan	sysycan
vefi	vevefi
polpe	popolpe
xosvyskotypok	xoxosvyskotypok
rawukobutu	rarawukobutu
topvucjur	totopvucjur
xikuwabcu	xixikuwabcu
kakipazlenu	kakakipazlenu
lop	lolop
gyxhyzja	gygyxhyzja
nembuqryno	nenembuqryno
lul	lulul
gafivuj	gagafivuj
pyjjif	pypyjjif
raf	raraf
begfu	bebegfu
pakjyj	papakjyj
fibhimyb	fifibhimyb
juspe	jujuspe
tegjespa	tetegjespa
xalihnyw	xaxalihnyw
wuvem	wuwuvem
nofceny	nonofceny
nazpervaxetbal	nanazpervaxetbal
gutu	gugutu
rirxi	ririrxi
vintishi	vivintishi
hobe	hohobe
zimne	zizimne
mivrob	mimivrob
castiwriqa	cacastiwriqa
sapucy	sasapucy
wupexy	wuwupexy
japa	jajapa
noktux	nonoktux
fuhu	fufuhu
wob	wowob
nogakyt	nonogakyt
fyx	fyfyx
fozod	fofozod
nokyz	nonokyz
qoxfevwudecy	qoqoxfevwudecy
xetrizitapon	xexetrizitapon
vacsitfutsac	vavacsitfutsac
luxavyjbapa	luluxavyjbapa
bah	babah
zoj	zozoj
gicgav	gigicgav
wujonpica	wuwujonpica
runvyvwodwyvqox	rurunvyvwodwyvqox
kuwaji	kukuwaji
vigxupmi	vivigxupmi
xulgeguhcem	xuxulgeguhcem
jacypqihetben	jajacypqihetben
fytes	fyfytes
tijzuful	titijzuful
jexnune	jejexnune
mutzifuwbyq	mumutzifuwbyq
hirpomtu	hihirpomtu
pija	pipija
muztydilcig	mumuztydilcig
manuj	mamanuj
viwsoltap	viviwsoltap
cuhcym	cucuhcym
qewga	qeqewga
hywig	hyhywig
cydzoq	cycydzoq
gossyb	gogossyb
jepoj	jejepoj
hunafduh	huhunafduh
rulda	rurulda
fazeh	fafazeh
wimlij	wiwimlij
mazo	mamazo
zit	zizit
deszazpuha	dedeszazpuha
qotvel	qoqotvel
rynos	ryrynos
pobigxafcufyp	popobigxafcufyp
fuvocqef	fufuvocqef
wawimu	wawawimu
vucyla	vuvucyla
honytuqipi	hohonytuqipi
morrom	momorrom
bewcivzo	bebewcivzo
fegi	fefegi
wisciksoqa	wiwisciksoqa
rasop	rarasop
lykdy	lylykdy
hanqaktigu	hahanqaktigu
kaqby	kakaqby
nijy	ninijy
megamdo	memegamdo
parizdave	paparizdave
sawu	sasawu
jyniriw	jyjyniriw
debyd	dedebyd
sojebel	sosojebel
rursy	rurursy
gihovkeljy	gigihovkeljy
zyq	zyzyq
kawzu	kakawzu
cetuzeci	cecetuzeci
muqy	mumuqy
lydemdi	lylydemdi
vyjuf	vyvyjuf
gicankax	gigicankax
kasjexniwtyh	kakasjexniwtyh
geceg	gegeceg
soka	sosoka
povweg	popovweg
cuslefytuc	cucuslefytuc
xedmursa	xexedmursa
berso	beberso
faxdiben	fafaxdiben
wixe	wiwixe
tymotkase	tytymotkase
kok	kokok
sacdo	sasacdo
cypke	cycypke
volwas	vovolwas
wori	wowori
jiraswugav	jijiraswugav
xiji	xixiji
wyvcu	wywyvcu
ficjuctojbolsu	fificjuctojbolsu
cyfot	cycyfot
lyrvof	lylyrvof
jenazu	jejenazu
mudbybno	mumudbybno
vilhufgej	vivilhufgej
bog	bobog
mekub	memekub
kelquf	kekelquf
bicad	bibicad
vurzule	vuvurzule
zebtessodogew	zezebtessodogew
pywot	pypywot
cavsab	cacavsab
sim	sisim
nikeliz	ninikeliz
qimhyn	qiqimhyn
piq	pipiq
kiwab	kikiwab
huxreqgiw	huhuxreqgiw
didiprog	dididiprog
kyqyvqafryt	kykyqyvqafryt
viqvoc	viviqvoc
balhuh	babalhuh
tuclow	tutuclow
daka	dadaka
ziqvybecyjga	ziziqvybecyjga
qutginzehywes	ququtginzehywes
rajponugdepfu	rarajponugdepfu
molat	momolat
huguxy	huhuguxy
tigkex	titigkex
cycif	cycycif
tavomsymjipul	tatavomsymjipul
fovex	fofovex
cysum	cycysum
mexuf	memexuf
goh	gogoh
togarar	totogarar
cekeke	cecekeke
vythic	vyvythic
mersin	memersin
noqvido	nonoqvido
zafaplyr	zazafaplyr
fuvvyz	fufuvvyz
red	rered
him	hihim
bumbehfycej	bubumbehfycej
mobmufalev	momobmufalev
beqvedtojtomvu	bebeqvedtojtomvu
duhahe	duduhahe
kiha	kikiha
jah	jajah
ketoqkiwkesyn	keketoqkiwkesyn
tyqu	tytyqu
fezqok	fefezqok
dijqi	didijqi
fasy	fafasy
sogebkyfjowa	sosogebkyfjowa
zuxu	zuzuxu
cogkugyxahro	cocogkugyxahro
bobag	bobobag
wupol	wuwupol
cekityrucjo	cecekityrucjo
qida	qiqida
jycqi	jyjycqi
riqboj	ririqboj
pico	pipico
luvdi	luluvdi
dosfo	dodosfo
fymfe	fyfymfe
wyfudlyl	wywyfudlyl
nolafepjoki	nonolafepjoki
dyjboqemecvy	dydyjboqemecvy
garxunwih	gagarxunwih
vihqucpa	vivihqucpa
xodcy	xoxodcy
typ	tytyp
pegowub	pepegowub
pebpi	pepebpi
dapot	dadapot
vuqajikjax	vuvuqajikjax
zekaklyrycbe	zezekaklyrycbe
qibcotzy	qiqibcotzy
cacle	cacacle
dufhef	dudufhef
qegypa	qeqegypa
neq	neneq
menjekdycxur	memenjekdycxur
xowek	xoxowek
sakyg	sasakyg
bigxij	bibigxij
bujbuc	bubujbuc
cowvuqaf	cocowvuqaf
dafbecxobre	dadafbecxobre
qogo	qoqogo
lejy	lelejy
vyccyt	vyvyccyt
mopxequ	momopxequ
ducemra	duducemra
gehbygwaski	gegehbygwaski
hytinimym	hyhytinimym
nyz	nynyz
xox	xoxox
zosox	zozosox
timwyj	titimwyj
vew	vevew
rewry	rerewry
zabrora	zazabrora
jomkujuhy	jojomkujuhy
qevhe	qeqevhe
wefsixho	wewefsixho
sylxat	sysylxat
zojtovra	zozojtovra
heqta	heheqta
jezomha	jejezomha
laha	lalaha
def	dedef
quwahlanpov	ququwahlanpov
vunxuklas	vuvunxuklas
lewuj	lelewuj
futi	fufuti
byne	bybyne
nozdoznaviv	nonozdoznaviv
jozxijkis	jojozxijkis
reqso	rereqso
myfib	mymyfib
vixe	vivixe
rydrotgat	ryrydrotgat
pabetduh	papabetduh
pysocqac	pypysocqac
pymecse	pypymecse
fotwav	fofotwav
madic	mamadic
rofo	rorofo
nacu	nanacu
wygy	wywygy
julwa	jujulwa
jevejjoblinwov	jejevejjoblinwov
ducxad	duducxad
putegusoxyz	puputegusoxyz
bojbotawa	bobojbotawa
zitmex	zizitmex
nytic	nynytic
xydjok	xyxydjok
quglypew	ququglypew
hycru	hyhycru
lykzoz	lylykzoz
xipjyfir	xixipjyfir
tyf	tytyf
riwtut	ririwtut
zuc	zuzuc
rur	rurur
cevzyqomohdy	cecevzyqomohdy
dejygbafrig	dedejygbafrig
juxevquvo	jujuxevquvo
lebonehdalvu	lelebonehdalvu
kuklozkihfuj	kukuklozkihfuj
zejo	zezejo
fici	fifici
neqyh	neneqyh
byvju	bybyvju
lobpocev	lolobpocev
jan	jajan
jibjoh	jijibjoh
safjeb	sasafjeb
vetsylxar	vevetsylxar
syl	sysyl
daqqon	dadaqqon
zyhdijcivcok	zyzyhdijcivcok
vuplyq	vuvuplyq
qelpybi	qeqelpybi
rereh	rerereh
xuxysu	xuxuxysu
coqgymib	cocoqgymib
hyvgu	hyhyvgu
qiz	qiqiz
kenofmo	kekenofmo
nywvyfyk	nynywvyfyk
cobxedcatdut	cocobxedcatdut
wuxmixtifjo	wuwuxmixtifjo
ten	teten
becen	bebecen
byb	bybyb
zawe	zazawe
xarutobdu	xaxarutobdu
zalotgejdocqi	zazalotgejdocqi
wuq	wuwuq
vuhhyt	vuvuhhyt
qogsic	qoqogsic
wipede	wiwipede
cubowby	cucubowby
buwnoseb	bubuwnoseb
xywah	xyxywah
kimnirolpyr	kikimnirolpyr
wubu	wuwubu
sitoxy	sisitoxy
hunoxa	huhunoxa
roby	roroby
tasa	tatasa
wiguskah	wiwiguskah
rehli	rerehli
myqlorehovnu	mymyqlorehovnu
lamgom	lalamgom
cemicufuwvik	cecemicufuwvik
giwvep	gigiwvep
regnafvog	reregnafvog
dokehhyf	dodokehhyf
lujbevpywlo	lulujbevpywlo
maci	mamaci
witdix	wiwitdix
rolge	rorolge
fivopidla	fifivopidla
vicic	vivicic
gelrygqate	gegelrygqate
nexid	nenexid
dojqiqazjurze	dodojqiqazjurze
gyri	gygyri
gegfic	gegegfic
sylqixizwahqo	sysylqixizwahqo
lol	lolol
jancu	jajancu
besso	bebesso
zyxcox	zyzyxcox
cyqwi	cycyqwi
qyctefy	qyqyctefy
togfypesnux	totogfypesnux
zoqgyc	zozoqgyc
jajetaq	jajajetaq
zowisu	zozowisu
sok	sosok
qyvzag	qyqyvzag
delbo	dedelbo
hakbypfoh	hahakbypfoh
resi	reresi
xacu	xaxacu
caxevi	cacaxevi
xykxutrovdam	xyxykxutrovdam
mela	memela
higut	hihigut
jigutsi	jijigutsi
corny	cocorny
nexa	nenexa
cotfux	cocotfux
biwygju	bibiwygju
xepdafkydja	xexepdafkydja
webysi	wewebysi
rewxeb	rerewxeb
taxjah	tataxjah
kyktaq	kykyktaq
musegqogda	mumusegqogda
zenduqmywxuvto	zezenduqmywxuvto
fipy	fifipy
cizloqfy	cicizloqfy
pylzo	pypylzo
hyv	hyhyv
wahetxyxre	wawahetxyxre
luwo	luluwo
xodexi	xoxodexi
baffemkuwora	babaffemkuwora
zovlozejdo	zozovlozejdo
buw	bubuw
vive	vivive
zodgyg	zozodgyg
guhu	guguhu
bicbev	bibicbev
putadrihpab	puputadrihpab
pybpu	pypybpu
xeh	xexeh
wymmodwokyqwi	wywymmodwokyqwi
myhodlimoha	mymyhodlimoha
taxmo	tataxmo
tiftuq	titiftuq
sinxefo	sisinxefo
biqy	bibiqy
culhy	cuculhy
xudsykhikih	xuxudsykhikih
zefi	zezefi
weldotyx	weweldotyx
qygewbulby	qyqygewbulby
xokxomti	xoxokxomti
lubum	lulubum
derys	dederys
zehmyppyjut	zezehmyppyjut
hoqfyw	hohoqfyw
sawybqug	sasawybqug
sabysih	sasabysih
leki	leleki
locumuwkacnu	lolocumuwkacnu
sasisi	sasasisi
nejyt	nenejyt
lypno	lylypno
jyj	jyjyj
zef	zezef
qowasrelny	qoqowasrelny
kavo	kakavo
ribmefysawim	riribmefysawim
riwhyq	ririwhyq
puvygtis	pupuvygtis
lokyz	lolokyz
kynvijy	kykynvijy
xasow	xaxasow
reku	rereku
qevxuvpatomkit	qeqevxuvpatomkit
gilux	gigilux
gud	gugud
cexpu	cecexpu
myfrago	mymyfrago
loqeh	loloqeh
pirod	pipirod
syfyq	sysyfyq
poguroh	popoguroh
zursyq	zuzursyq
nyvza	nynyvza
sira	sisira
satudro	sasatudro
rysothirobep	ryrysothirobep
zaqupmabyz	zazaqupmabyz
res	reres
puwene	pupuwene
pub	pupub
maxerbejla	mamaxerbejla
nybtun	nynybtun
bofsotmipico	bobofsotmipico
zisi	zizisi
kucox	kukucox
wofaw	wowofaw
dogqil	dodogqil
wip	wiwip
riquvwotehge	ririquvwotehge
sumerev	susumerev
cakez	cacakez
womexcom	wowomexcom
xuw	xuxuw
zegwerdim	zezegwerdim
hussejegy	huhussejegy
daftyzvad	dadaftyzvad
gyqyxy	gygyqyxy
buxhuh	bubuxhuh
wedetwegre	wewedetwegre
kijfigser	kikijfigser
corqidsakukboh	cocorqidsakukboh
woktymhuppihtuk	wowoktymhuppihtuk
nuqry	nunuqry
jorfuz	jojorfuz
podviq	popodviq
tizqypgecnyhdy	titizqypgecnyhdy
pajfiljonmob	papajfiljonmob
wivirycakqe	wiwivirycakqe
sezzu	sesezzu
rytak	ryrytak
nerfu	nenerfu
qiha	qiqiha
mikyjfoqetvi	mimikyjfoqetvi
mafcirhu	mamafcirhu
kige	kikige
riwonel	ririwonel
gejazegube	gegejazegube
zykgype	zyzykgype
xyvcu	xyxyvcu
cibin	cicibin
bokuz	bobokuz
poveb	popoveb
jivzog	jijivzog
zudzobkiv	zuzudzobkiv
bohxa	bobohxa
pufsyjfynmuko	pupufsyjfynmuko
tyqykud	tytyqykud
mogo	momogo
rek	rerek
towdad	totowdad
pihi	pipihi
vitri	vivitri
dohoxy	dodohoxy
wycpep	wywycpep
lavelit	lalavelit
fiqxi	fifiqxi
syd	sysyd
lovo	lolovo
xuqes	xuxuqes
xyvwez	xyxyvwez
juficnyxisyv	jujuficnyxisyv
rulym	rurulym
gydyktod	gygydyktod
cydixaqucsu	cycydixaqucsu
vahjy	vavahjy
biqyp	bibiqyp
gapi	gagapi
bathortysjik	babathortysjik
siwhew	sisiwhew
dystekok	dydystekok
zex	zezex
mipafbugo	mimipafbugo
masidyzvo	mamasidyzvo
donkyq	dodonkyq
ceqe	ceceqe
loce	loloce
jyvsasof	jyjyvsasof
tupeqlexo	tutupeqlexo
nazzez	nanazzez
kowybtiry	kokowybtiry
dulokwyrxyvir	dudulokwyrxyvir
xahoxgomza	xaxahoxgomza
law	lalaw
xepuz	xexepuz
vuc	vuvuc
zanfy	zazanfy
hyvadkara	hyhyvadkara
tehsi	tetehsi
negfylyboba	nenegfylyboba
xaj	xaxaj
nebla	nenebla
lyg	lylyg
kozqu	kokozqu
wyhsim	wywyhsim
cib	cicib
myzuqe	mymyzuqe
joqnezfo	jojoqnezfo
ryhjevxojxaf	ryryhjevxojxaf
lavom	lalavom
kotujemirxy	kokotujemirxy
qazkyl	qaqazkyl
saq	sasaq
zullod	zuzullod
kupmesepo	kukupmesepo
kiva	kikiva
ledyxeq	leledyxeq
qypoxe	qyqypoxe
tes	tetes
pempe	pepempe
tahbajnajra	tatahbajnajra
kowu	kokowu
sicamcesejrel	sisicamcesejrel
qopopvi	qoqopopvi
fabbu	fafabbu
jizecynyrfa	jijizecynyrfa
viknigzyhuco	viviknigzyhuco
gowub	gogowub
lihobaf	lilihobaf
cerryti	cecerryti
qab	qaqab
wihjo	wiwihjo
radeh	raradeh
rylheq	ryrylheq
xaz	xaxaz
zobtezo	zozobtezo
xezjyp	xexezjyp
doc	dodoc
welukiljup	wewelukiljup
ceragiltatum	ceceragiltatum
sufpylipxyr	susufpylipxyr
qope	qoqope
jokalvir	jojokalvir
safusise	sasafusise
vyqy	vyvyqy
taho	tataho
zikfac	zizikfac
latxi	lalatxi
silpev	sisilpev
sixup	sisixup
qambon	qaqambon
zunki	zuzunki
xohiddemcynoq	xoxohiddemcynoq
jar	jajar
zehunfurycve	zezehunfurycve
lapxocun	lalapxocun
halvotryv	hahalvotryv
nilirfujygcyn	ninilirfujygcyn
redlogyviluw	reredlogyviluw
jymyz	jyjymyz
mapmub	mamapmub
zowal	zozowal
waddufdofgih	wawaddufdofgih
cerjeh	cecerjeh
vyjca	vyvyjca
vihama	vivihama
zypsop	zyzypsop
mosihnuclemlan	momosihnuclemlan
gyf	gygyf
guvowo	guguvowo
jowrawaxqy	jojowrawaxqy
lenag	lelenag
xamjabkyfsof	xaxamjabkyfsof
bilhapdarog	bibilhapdarog
dygexqy	dydygexqy
mipelhyfupu	mimipelhyfupu
bebuf	bebebuf
hahy	hahahy
diguwgoj	didiguwgoj
zecexippergyp	zezecexippergyp
puxfuq	pupuxfuq
gypef	gygypef
fez	fefez
todoridavnez	totodoridavnez
kabfu	kakabfu
xucdyt	xuxucdyt
xexa	xexexa
woz	wowoz
kuqa	kukuqa
damekfu	dadamekfu
bez	bebez
kuttinlos	kukuttinlos
dupwita	dudupwita
qisix	qiqisix
qihne	qiqihne
vunkyfmyxfycna	vuvunkyfmyxfycna
tokav	totokav
hewemjuzyxeb	hehewemjuzyxeb
vowxapvogkamwot	vovowxapvogkamwot
nazxok	nanazxok
sylawso	sysylawso
popvyqfyfo	popopvyqfyfo
coqu	cocoqu
zamcid	zazamcid
revytyl	rerevytyl
puhehxew	pupuhehxew
xodgyp	xoxodgyp
wahi	wawahi
zesawwy	zezesawwy
kyta	kykyta
juju	jujuju
byq	bybyq
wybne	wywybne
wewcin	wewewcin
jylojejhim	jyjylojejhim
fepsozehure	fefepsozehure
titajtusyr	tititajtusyr
wadotebitsu	wawadotebitsu
cehfibsywditab	cecehfibsywditab
zufquf	zuzufquf
xise	xixise
bybad	bybybad
tycka	tytycka
qeqvihixizy	qeqeqvihixizy
xeddoqwo	xexeddoqwo
bucodukig	bubucodukig
moqyhymurmub	momoqyhymurmub
haxe	hahaxe
wahvupzo	wawahvupzo
sepicomewi	sesepicomewi
sygigirsit	sysygigirsit
ledodrirona	leledodrirona
haghi	hahaghi
lyhson	lylyhson
dyxozuh	dydyxozuh
lefjomqofavar	lelefjomqofavar
tuvergoflibdet	tutuvergoflibdet
jabful	jajabful
qelqydxawawu	qeqelqydxawawu
roscix	roroscix
cisrize	cicisrize
madopomyt	mamadopomyt
fyvdu	fyfyvdu
reje	rereje
jipzul	jijipzul
xufek	xuxufek
xoxy	xoxoxy
gijsap	gigijsap
xip	xixip
jujygmejula	jujujygmejula
vywef	vyvywef
denpagzyd	dedenpagzyd
kidifkinwarxo	kikidifkinwarxo
vambap	vavambap
pynalmev	pypynalmev
dyjcalhu	dydyjcalhu
fyd	fyfyd
dybpoholhowyl	dydybpoholhowyl
luwza	luluwza
xohik	xoxohik
bym	bybym
vazzin	vavazzin
lulys	lululys
ful	fuful
dyzpode	dydyzpode
setip	sesetip
cakyk	cacakyk
rihryfhe	ririhryfhe
tod	totod
pomompeb	popomompeb
govo	gogovo
nidagulassy	ninidagulassy
moge	momoge
secrybmorrevu	sesecrybmorrevu
sutva	susutva
jivog	jijivog
zuda	zuzuda
pycjufwak	pypycjufwak
buluxwadmuzi	bubuluxwadmuzi
lejju	lelejju
lywow	lylywow
gyllybuxihy	gygyllybuxihy
kasxu	kakasxu
syqif	sysyqif
muh	mumuh
kurega	kukurega
qan	qaqan
biwcuqe	bibiwcuqe
ramy	raramy
zafipwuboj	zazafipwuboj
suwlunek	susuwlunek
taket	tataket
cekdap	cecekdap
symyr	sysymyr
levemri	lelevemri
xazjodkyc	xaxazjodkyc
dygyhwibizyx	dydygyhwibizyx
tamin	tatamin
nez	nenez
bylxybge	bybylxybge
zynafave	zyzynafave
cabkow	cacabkow
fyhem	fyfyhem
jeksytemad	jejeksytemad
cice	cicice
mufupykpyror	mumufupykpyror
cifzopeq	cicifzopeq
nanud	nananud
lejxyg	lelejxyg
rixa	ririxa
kicluty	kikicluty
zurxonyk	zuzurxonyk
dugtorloz	dudugtorloz
jasmit	jajasmit
mywxujih	mymywxujih
vynhes	vyvynhes
qiliw	qiqiliw
xeca	xexeca
dugym	dudugym
kuh	kukuh
nyma	nynyma
syna	sysyna
jofug	jojofug
bocor	bobocor
basmohirgugob	babasmohirgugob
myx	mymyx
nopo	nonopo
kafohhin	kakafohhin
retmig	reretmig
byggif	bybyggif
vulam	vuvulam
mybok	mymybok
foswefkapwup	fofoswefkapwup
rurfopude	rururfopude
wonu	wowonu
hilfeq	hihilfeq
fyfletpe	fyfyfletpe
galky	gagalky
vemzyd	vevemzyd
bexyxron	bebexyxron
puwako	pupuwako
fixonkysowy	fifixonkysowy
nohzaqduhbo	nonohzaqduhbo
mifdo	mimifdo
git	gigit
silukono	sisilukono
coqgup	cocoqgup
bopmiwib	bobopmiwib
hat	hahat
ruzyt	ruruzyt
muczeq	mumuczeq
korkuxropusam	kokorkuxropusam
rivfuz	ririvfuz
zurol	zuzurol
cytyshugihret	cycytyshugihret
bamhihka	babamhihka
sirmosjy	sisirmosjy
teqip	teteqip
nohormo	nonohormo
coruftohxaha	cocoruftohxaha
fybos	fyfybos
pir	pipir
hiscoza	hihiscoza
luru	luluru
vonejwagceclir	vovonejwagceclir
tarba	tatarba
wevde	wewevde
tyno	tytyno
qycotfon	qyqycotfon
ryvkibzyx	ryryvkibzyx
xavadizlix	xaxavadizlix
zokex	zozokex
vugymu	vuvugymu
fisrus	fifisrus
byrmugypiztum	bybyrmugypiztum
nave	nanave
tovugic	totovugic
figpis	fifigpis
rewmyla	rerewmyla
wehed	wewehed
gabuz	gagabuz
zanil	zazanil
syfke	sysyfke
luzu	luluzu
fujdezys	fufujdezys
zevwinryn	zezevwinryn
zuzru	zuzuzru
cuwremep	cucuwremep
mubosoq	mumubosoq
mabdudujok	mamabdudujok
jowcic	jojowcic
modinfaqwane	momodinfaqwane
relixox	rerelixox
fas	fafas
daqxetpewquro	dadaqxetpewquro
wimxe	wiwimxe
giwi	gigiwi
foqipapiz	fofoqipapiz
vubji	vuvubji
firy	fifiry
fysol	fyfysol
tyxi	tytyxi
quhjelulzycij	ququhjelulzycij
kigax	kikigax
cigij	cicigij
sehne	sesehne
diza	didiza
nuw	nunuw
vegvag	vevegvag
paju	papaju
pohkedguv	popohkedguv
tisyxreg	titisyxreg
putus	puputus
tesi	tetesi
himu	hihimu
riz	ririz
daz	dadaz
nevwikgag	nenevwikgag
fymuw	fyfymuw
cifylzohti	cicifylzohti
nasresnaccem	nanasresnaccem
hadufkona	hahadufkona
cenuw	cecenuw
nuji	nunuji
lujec	lulujec
tyse	tytyse
loxhebyguz	loloxhebyguz
qemwur	qeqemwur
foringec	foforingec
kyktitzir	kykyktitzir
xyzafjo	xyxyzafjo
lyrxa	lylyrxa
hejbec	hehejbec
wegpukgobsov	wewegpukgobsov
pyptugtuqval	pypyptugtuqval
gokqaf	gogokqaf
qazi	qaqazi
loxmit	loloxmit
wycvyw	wywycvyw
duhhym	duduhhym
hytry	hyhytry
hosa	hohosa
nohza	nonohza
kefa	kekefa
cyxyl	cycyxyl
jykqi	jyjykqi
fixakura	fifixakura
lewqy	lelewqy
zelnyxvimibva	zezelnyxvimibva
pedji	pepedji
fenuluca	fefenuluca
mytfu	mymytfu
lulexar	lululexar
sopiqzyw	sosopiqzyw
kybewada	kykybewada
jonva	jojonva
xiqo	xixiqo
duvepoq	duduvepoq
fujfaret	fufujfaret
hiqcut	hihiqcut
wer	wewer
hulan	huhulan
luk	luluk
dipqujtipaj	didipqujtipaj
syttun	sysyttun
mix	mimix
nynawofroc	nynynawofroc
zod	zozod
togu	totogu
ceccemyq	cececcemyq
jajysury	jajajysury
jiwerif	jijiwerif
rake	rarake
pugwaqpujcohmys	pupugwaqpujcohmys
ker	keker
hegumdegic	hehegumdegic
lygefnyc	lylygefnyc
qiskycga	qiqiskycga
qiggyh	qiqiggyh
bojdeltodba	bobojdeltodba
hucmawyl	huhucmawyl
xipukom	xixipukom
zobzukem	zozobzukem
zeghizikyve	zezeghizikyve
bimodtep	bibimodtep
wus	wuwus
pesuc	pepesuc
xel	xexel
lef	lelef
nymfaburuk	nynymfaburuk
bohux	bobohux
symih	sysymih
lymoc	lylymoc
rotpuxes	rorotpuxes
lox	lolox
ratul	raratul
dow	dodow
lomqo	lolomqo
cyjzuk	cycyjzuk
nynu	nynynu
gaga	gagaga
tenoj	tetenoj
husqoj	huhusqoj
bak	babak
wezy	wewezy
ser	seser
pemvy	pepemvy
kukufacubek	kukukufacubek
jajlof	jajajlof
rasy	rarasy
joqydumyrfen	jojoqydumyrfen
ceqyxnac	ceceqyxnac
jifho	jijifho
wasado	wawasado
cecju	cececju
podtanotbahxiv	popodtanotbahxiv
dupy	dudupy
zyquwqefiw	zyzyquwqefiw
viqok	viviqok
vypa	vyvypa
bivhu	bibivhu
nomy	nonomy
bekitde	bebekitde
dydohkezapbif	dydydohkezapbif
lizuza	lilizuza
bure	bubure
hicikbi	hihicikbi
xaqfic	xaxaqfic
kywamhe	kykywamhe
rudo	rurudo
pamki	papamki
habypcexapa	hahabypcexapa
fyvre	fyfyvre
manidsacreco	mamanidsacreco
bokaz	bobokaz
hulmig	huhulmig
rocajygihfi	rorocajygihfi
kocifyloz	kokocifyloz
puxipe	pupuxipe
vyn	vyvyn
qugraxhogoksat	ququgraxhogoksat
pafedu	papafedu
zakvot	zazakvot
lepir	lelepir
kynub	kykynub
fexalfyfy	fefexalfyfy
myz	mymyz
boghysocobgyk	boboghysocobgyk
fogimobdom	fofogimobdom
kujozizodo	kukujozizodo
gecotoc	gegecotoc
kikit	kikikit
fijeg	fifijeg
movceqxaf	momovceqxaf
buvna	bubuvna
vismoh	vivismoh
gywulmy	gygywulmy
gecxoh	gegecxoh
nymyxvo	nynymyxvo
fitsix	fifitsix
gewof	gegewof
welicewlap	wewelicewlap
mofy	momofy
mynowpe	mymynowpe
fagivo	fafagivo
pobfo	popobfo
zepiqpovoxo	zezepiqpovoxo
fomiv	fofomiv
jefhejtiffatnon	jejefhejtiffatnon
weqvi	weweqvi
qecsitbalo	qeqecsitbalo
kopo	kokopo
suby	susuby
pubgo	pupubgo
qaxu	qaqaxu
kopdeh	kokopdeh
ryb	ryryb
jidiw	jijidiw
sesucnezytoc	sesesucnezytoc
byv	bybyv
kahgi	kakahgi
ryqanpunuspu	ryryqanpunuspu
byjneq	bybyjneq
binpi	bibinpi
zoshuk	zozoshuk
xote	xoxote
goc	gogoc
qyjyw	qyqyjyw
vircos	vivircos
kiracabdo	kikiracabdo
keteq	keketeq
riqextu	ririqextu
lydli	lylydli
dygatfe	dydygatfe
sudxyv	susudxyv
leqakovxym	leleqakovxym
zobyqo	zozobyqo
xokmidcu	xoxokmidcu
xadajmuhjuzu	xaxadajmuhjuzu
buvuk	bubuvuk
ges	geges
nervo	nenervo
redeqru	reredeqru
mytuqu	mymytuqu
bumwuxni	bubumwuxni
recgadxovsa	rerecgadxovsa
tinvulehujef	titinvulehujef
jonuver	jojonuver
lusuk	lulusuk
tusuqyhmys	tutusuqyhmys
kakehac	kakakehac
kalivrujar	kakalivrujar
mirugap	mimirugap
weca	weweca
jyke	jyjyke
qecy	qeqecy
gozwomi	gogozwomi
feror	feferor
bydyr	bybydyr
hyhu	hyhyhu
bigy	bibigy
poxab	popoxab
bulok	bubulok
jimeci	jijimeci
fubjar	fufubjar
byt	bybyt
tyh	tytyh
wobicso	wowobicso
gupo	gugupo
vohra	vovohra
tigoc	titigoc
lycyx	lylycyx
jygqihi	jyjygqihi
tatnumdoc	tatatnumdoc
qybugytyjef	qyqybugytyjef
rehawvakew	rerehawvakew
mebygo	memebygo
buqy	bubuqy
sodfax	sosodfax
zismaxopjapod	zizismaxopjapod
xyrfox	xyxyrfox
dukop	dudukop
vemwi	vevemwi
vegwijjuqkypsa	vevegwijjuqkypsa
nasbotyhil	nanasbotyhil
cepbogiqniz	cecepbogiqniz
tylla	tytylla
zybesix	zyzybesix
lasgedpu	lalasgedpu
gywejun	gygywejun
bovawudwy	bobovawudwy
locarytjiq	lolocarytjiq
hulsensivsaz	huhulsensivsaz
nirxe	ninirxe
zofca	zozofca
fuzu	fufuzu
xitwi	xixitwi
hedrij	hehedrij
dozwicap	dodozwicap
vewow	vevewow
xyggovpetji	xyxyggovpetji
lyxwazhuge	lylyxwazhuge
july	jujuly
kympyrucqysy	kykympyrucqysy
vizyhzid	vivizyhzid
pevemip	pepevemip
xyfu	xyxyfu
xeqniji	xexeqniji
qorocquqfyr	qoqorocquqfyr
myrcaffazak	mymyrcaffazak
jesovvixqi	jejesovvixqi
qomwom	qoqomwom
lal	lalal
heklanufne	heheklanufne
jekar	jejekar
bulyvehkem	bubulyvehkem
dufgyqe	dudufgyqe
qyvojizrud	qyqyvojizrud
juzta	jujuzta
tedi	tetedi
fozty	fofozty
tatyk	tatatyk
loj	loloj
jatmysgi	jajatmysgi
nixobcapzu	ninixobcapzu
fazycdax	fafazycdax
xih	xixih
tanza	tatanza
fib	fifib
caqwijvyttavpyz	cacaqwijvyttavpyz
vymsonhy	vyvymsonhy
tegwyzif	tetegwyzif
gytze	gygytze
ginvyla	giginvyla
cihnybiloz	cicihnybiloz
tiptuhbah	titiptuhbah
puz	pupuz
sobyg	sosobyg
rimu	ririmu
pudatimvis	pupudatimvis
qas	qaqas
bumi	bubumi
jowe	jojowe
larkyrex	lalarkyrex
dewnaqrahyva	dedewnaqrahyva
dehqo	dedehqo
dydec	dydydec
joccy	jojoccy
xiwqowxyno	xixiwqowxyno
wada	wawada
carbeb	cacarbeb
subiv	susubiv
luvulez	luluvulez
zyxamuweskis	zyzyxamuweskis
kido	kikido
xises	xixises
vefly	vevefly
cynubdadmesrar	cycynubdadmesrar
dijlu	didijlu
sigvatikep	sisigvatikep
guhpa	guguhpa
zije	zizije
jegipu	jejegipu
kulyl	kukulyl
xuvbuxca	xuxuvbuxca
guxoz	guguxoz
damkolzar	dadamkolzar
lojidvudyrfa	lolojidvudyrfa
hesjop	hehesjop
nyxse	nynyxse
madepqec	mamadepqec
wudy	wuwudy
cadvys	cacadvys
soroqi	sosoroqi
fywubywyly	fyfywubywyly
haqat	hahaqat
xiqyw	xixiqyw
lyvyh	lylyvyh
vedvi	vevedvi
sibzulte	sisibzulte
hig	hihig
lorzap	lolorzap
gaguzgyntugy	gagaguzgyntugy
janozqizywpo	jajanozqizywpo
timu	titimu
kopkif	kokopkif
remux	reremux
wuc	wuwuc
vodka	vovodka
ritsogxegyf	riritsogxegyf
pufnaruso	pupufnaruso
sabwefa	sasabwefa
biqegfepusdik	bibiqegfepusdik
fepnuwbur	fefepnuwbur
wihel	wiwihel
toryse	totoryse
vipsi	vivipsi
ridux	riridux
zyzryda	zyzyzryda
molni	momolni
fadid	fafadid
dekihu	dedekihu
fewfabdupqodte	fefewfabdupqodte
sicyso	sisicyso
xyle	xyxyle
govi	gogovi
giqwiqkannywjaf	gigiqwiqkannywjaf
fozexorevhiv	fofozexorevhiv
kuhsorubiv	kukuhsorubiv
xyqychiv	xyxyqychiv
sakvux	sasakvux
hiz	hihiz
butahnic	bubutahnic
pohy	popohy
lagajiw	lalagajiw
sogja	sosogja
wybuv	wywybuv
qobcuqsyt	qoqobcuqsyt
cuxdu	cucuxdu
kubvy	kukubvy
lexorrunin	lelexorrunin
ruhdy	ruruhdy
selhukvocgo	seselhukvocgo
turoka	tuturoka
civu	cicivu
mixaf	mimixaf
bubkofky	bububkofky
qafyfunyq	qaqafyfunyq
borutcipmo	boborutcipmo
xunvimfusrefto	xuxunvimfusrefto
bowco	bobowco
tejvyvoq	tetejvyvoq
mys	mymys
micjo	mimicjo
xywissiz	xyxywissiz
qaba	qaqaba
sushy	susushy
cukhi	cucukhi
dadhuqy	dadadhuqy
viwusbosheqxyv	viviwusbosheqxyv
qesmibidejra	qeqesmibidejra
cuci	cucuci
reqpazi	rereqpazi
sytvyv	sysytvyv
sozena	sosozena
bymyr	bybymyr
luki	luluki
xufub	xuxufub
vewzipabo	vevewzipabo
kelit	kekelit
sih	sisih
dipkaso	didipkaso
nifoj	ninifoj
fyrse	fyfyrse
wexaw	wewexaw
jupurcaz	jujupurcaz
soloh	sosoloh
wefxy	wewefxy
qirpybwis	qiqirpybwis
jukvy	jujukvy
gomgymogtykroh	gogomgymogtykroh
bupqaldar	bubupqaldar
tejkonigo	tetejkonigo
qybfejnob	qyqybfejnob
juppy	jujuppy
xissizi	xixissizi
jebbi	jejebbi
boxqymos	boboxqymos
helyb	hehelyb
rod	rorod
humazu	huhumazu
valukvuruwhyp	vavalukvuruwhyp
nevgyj	nenevgyj
tafnokjilob	tatafnokjilob
mow	momow
bylycujkofih	bybylycujkofih
ciqfupuc	ciciqfupuc
cok	cocok
gehasijceduz	gegehasijceduz
gobenowi	gogobenowi
zoq	zozoq
vipek	vivipek
mesnigor	memesnigor
hygog	hyhygog
zupy	zuzupy
qizoxix	qiqizoxix
nat	nanat
xop	xoxop
mabucum	mamabucum
wahyrnurci	wawahyrnurci
xyslep	xyxyslep
qytyziw	qyqytyziw
gimecqilyqe	gigimecqilyqe
fav	fafav
putiblib	puputiblib
hulgy	huhulgy
vareddal	vavareddal
herini	heherini
bovbir	bobovbir
delyw	dedelyw
dampu	dadampu
fysvumlukatxy	fyfysvumlukatxy
jewdikho	jejewdikho
qabjezqolovsyb	qaqabjezqolovsyb
qysce	qyqysce
zedzy	zezedzy
ruca	ruruca
vukcowmop	vuvukcowmop
necadraw	nenecadraw
hudiv	huhudiv
zyntoxo	zyzyntoxo
fictentivy	fifictentivy
tezajizy	tetezajizy
nabu	nanabu
soh	sosoh
xymesnepadvyr	xyxymesnepadvyr
fukqy	fufukqy
hutfuril	huhutfuril
moce	momoce
dorhokza	dodorhokza
sixsitruw	sisixsitruw
motjup	momotjup
xab	xaxab
hipjyl	hihipjyl
xivybexxu	xixivybexxu
bevjulemul	bebevjulemul
zejhal	zezejhal
gonuxka	gogonuxka
widsix	wiwidsix
jetan	jejetan
ruka	ruruka
vohawgu	vovohawgu
ludbabjug	luludbabjug
dubfyrub	dudubfyrub
nuqalfi	nunuqalfi
satmi	sasatmi
xihzud	xixihzud
vukpis	vuvukpis
qazoxvykqorxu	qaqazoxvykqorxu
vinu	vivinu
norfabxav	nonorfabxav
lahacramsul	lalahacramsul
vutjafvokfo	vuvutjafvokfo
myqaxmopi	mymyqaxmopi
vacyb	vavacyb
mit	mimit
bidi	bibidi
noryplarxevu	nonoryplarxevu
pij	pipij
daccimja	dadaccimja
hama	hahama
selizve	seselizve
gequvnapdufeb	gegequvnapdufeb
hih	hihih
sehoj	sesehoj
rajlozfafqinbal	rarajlozfafqinbal
gezoz	gegezoz
kime	kikime
fyqmycrykivto	fyfyqmycrykivto
hujby	huhujby
rebim	rerebim
vapav	vavapav
fudqij	fufudqij
janrod	jajanrod
kihigcys	kikihigcys
zysyd	zyzysyd
vehu	vevehu
pogune	popogune
nidaw	ninidaw
xihgugaccubnun	xixihgugaccubnun
bufizekity	bubufizekity
sokoznub	sosokoznub
pomig	popomig
koqwyjjo	kokoqwyjjo
gylvud	gygylvud
lomqexircusqe	lolomqexircusqe
dubvyxnod	dudubvyxnod
nevu	nenevu
rebvy	rerebvy
dopitby	dodopitby
zukurovywi	zuzukurovywi
hekdy	hehekdy
lesikavilsoz	lelesikavilsoz
sizyxnim	sisizyxnim
war	wawar
wyggadur	wywyggadur
dulzymcadlezy	dudulzymcadlezy
vamu	vavamu
koqpi	kokoqpi
jepwu	jejepwu
latuvhu	lalatuvhu
jagujam	jajagujam
higwylselibeq	hihigwylselibeq
cometfutvylav	cocometfutvylav
tuno	tutuno
birbu	bibirbu
hunoteze	huhunoteze
raca	raraca
sywzazu	sysywzazu
nagavikyqvav	nanagavikyqvav
miz	mimiz
gobavmobjyf	gogobavmobjyf
xefuw	xexefuw
vufwuttymkyxi	vuvufwuttymkyxi
pazqalduw	papazqalduw
vakgah	vavakgah
cybidy	cycybidy
nowugpuje	nonowugpuje
likda	lilikda
gulfes	gugulfes
cedyg	cecedyg
myjgih	mymyjgih
vegvec	vevegvec
duco	duduco
zugsyp	zuzugsyp
fabu	fafabu
ryconpop	ryryconpop
hovunby	hohovunby
fivtexe	fifivtexe
damdupduteq	dadamdupduteq
xyl	xyxyl
qamux	qaqamux
hyvwe	hyhyvwe
bovpu	bobovpu
fikem	fifikem
zefvo	zezefvo
dezexbe	dedezexbe
raqevnyjbify	raraqevnyjbify
nopoj	nonopoj
dokjabex	dodokjabex
xaf	xaxaf
zagazyv	zazagazyv
savwoxsugve	sasavwoxsugve
kuccu	kukuccu
nejwenem	nenejwenem
sodopa	sosodopa
pibze	pipibze
jumnatgusmec	jujumnatgusmec
sifnuh	sisifnuh
renwod	rerenwod
sohcuwgihe	sosohcuwgihe
cekfolxavbaccur	cecekfolxavbaccur
kedizdydrud	kekedizdydrud
gecjeno	gegecjeno
zoltiporso	zozoltiporso
wis	wiwis
bid	bibid
xijozbis	xixijozbis
wejlyzetuzi	wewejlyzetuzi
fum	fufum
wuvoldum	wuwuvoldum
myvagvivca	mymyvagvivca
siskah	sisiskah
vakin	vavakin
xeces	xexeces
wagy	wawagy
xysukepfym	xyxysukepfym
muf	mumuf
jocu	jojocu
hifwa	hihifwa
nimyw	ninimyw
pabhis	papabhis
poswoz	poposwoz
jogheqbevxuhyh	jojogheqbevxuhyh
caralapitni	cacaralapitni
nytu	nynytu
wonnydxe	wowonnydxe
gufoh	gugufoh
qugba	ququgba
pezbap	pepezbap
fihwa	fifihwa
dabditqucgekeb	dadabditqucgekeb
myvypiz	mymyvypiz
qegsagbyforlo	qeqegsagbyforlo
wychon	wywychon
raru	rararu
rumuk	rurumuk
tyboz	tytyboz
xyzdop	xyxyzdop
qax	qaqax
comikfyg	cocomikfyg
rubqo	rurubqo
fahkitazpycnu	fafahkitazpycnu
bylo	bybylo
deqivy	dedeqivy
folpozupufu	fofolpozupufu
lytgej	lylytgej
coshod	cocoshod
dapip	dadapip
duqo	duduqo
mahhalyt	mamahhalyt
xyfoh	xyxyfoh
zunenifyh	zuzunenifyh
xojgiq	xoxojgiq
vajo	vavajo
wohul	wowohul
hahef	hahahef
poqjyf	popoqjyf
taze	tataze
johaptul	jojohaptul
soxe	sosoxe
muhsufzyttod	mumuhsufzyttod
xyjzyq	xyxyjzyq
foceg	fofoceg
wonirvubiq	wowonirvubiq
vufurli	vuvufurli
dumny	dudumny
nirfamcyxtopda	ninirfamcyxtopda
fihpu	fifihpu
bowfux	bobowfux
xihby	xixihby
labbos	lalabbos
tuszav	tutuszav
pexlih	pepexlih
rospaxpifi	rorospaxpifi
tasyzfap	tatasyzfap
mojfo	momojfo
xajxyn	xaxajxyn
mazjo	mamazjo
tuca	tutuca
byja	bybyja
masosi	mamasosi
sebzyhco	sesebzyhco
senyldat	sesenyldat
wyhbob	wywyhbob
lekyc	lelekyc
sube	susube
johjiv	jojohjiv
tigac	titigac
refa	rerefa
hif	hihif
qux	ququx
bindi	bibindi
fakuqzu	fafakuqzu
cotke	cocotke
hujzifta	huhujzifta
cogude	cocogude
xuc	xuxuc
qedufije	qeqedufije
xylytpejdifep	xyxylytpejdifep
joqfum	jojoqfum
nobsuqbuva	nonobsuqbuva
geljytsy	gegeljytsy
fistokuwhi	fifistokuwhi
waqoky	wawaqoky
giqceg	gigiqceg
hidok	hihidok
sebas	sesebas
rijseg	ririjseg
gaxibciq	gagaxibciq
zysokyxo	zyzysokyxo
dyhlu	dydyhlu
wybikrexuwwe	wywybikrexuwwe
notzyk	nonotzyk
gygne	gygygne
dihwyci	didihwyci
bejvypyw	bebejvypyw
tubub	tutubub
mym	mymym
lesab	lelesab
qyhzic	qyqyhzic
xemhe	xexemhe
lacqah	lalacqah
sowtarij	sosowtarij
teweqyv	teteweqyv
zyl	zyzyl
takzim	tatakzim
levfa	lelevfa
favgog	fafavgog
qezlydlaga	qeqezlydlaga
poklyvuvek	popoklyvuvek
mugyxkatsejmo	mumugyxkatsejmo
nysifsy	nynysifsy
wosloruwsyge	wowosloruwsyge
det	dedet
kaqjifsu	kakaqjifsu
nocor	nonocor
biwsaplefo	bibiwsaplefo
pele	pepele
lolyttexgixke	lololyttexgixke
tizagbybqiq	titizagbybqiq
qumfaf	ququmfaf
qowno	qoqowno
qyge	qyqyge
qahesmodhico	qaqahesmodhico
kycku	kykycku
filgoh	fifilgoh
puhzi	pupuhzi
ruzug	ruruzug
xygap	xyxygap
qeqxunqog	qeqeqxunqog
vuxy	vuvuxy
nywse	nynywse
jik	jijik
cosykyrax	cocosykyrax
pomwozoz	popomwozoz
pimka	pipimka
huhbem	huhuhbem
heku	heheku
lerbeqamby	lelerbeqamby
kak	kakak
rijy	ririjy
hekydvar	hehekydvar
bajono	babajono
kodu	kokodu
vavnyx	vavavnyx
hega	hehega
sytuf	sysytuf
xemkuweb	xexemkuweb
daxohkylec	dadaxohkylec
cifyxkyj	cicifyxkyj
riqoxdec	ririqoxdec
qaqis	qaqaqis
lyjjafirkejdom	lylyjjafirkejdom
razojguz	rarazojguz
dycutpe	dydycutpe
fejbu	fefejbu
roqsub	roroqsub
hadqemy	hahadqemy
zecsejol	zezecsejol
zenhy	zezenhy
liglezo	liliglezo
zugordog	zuzugordog
pila	pipila
jadkitxyju	jajadkitxyju
zab	zazab
toswipesdy	totoswipesdy
jomoq	jojomoq
wihab	wiwihab
nuce	nunuce
kumpy	kukumpy
kaqhebaq	kakaqhebaq
zafcaby	zazafcaby
nadwuhtiz	nanadwuhtiz
tibyxwa	titibyxwa
myxeseqvyw	mymyxeseqvyw
rompot	rorompot
luktihivil	luluktihivil
taquq	tataquq
zyp	zyzyp
ware	waware
nitat	ninitat
cowymnyqke	cocowymnyqke
kalmeciwwac	kakalmeciwwac
cujewaq	cucujewaq
vamituz	vavamituz
ciqor	ciciqor
tuti	tututi
qarles	qaqarles
xebwisymmyj	xexebwisymmyj
wyqusbaj	wywyqusbaj
myllol	mymyllol
dekhocem	dedekhocem
wofjelxifhalan	wowofjelxifhalan
cyrwyz	cycyrwyz
robkompeblacu	rorobkompeblacu
hyrkesusvoxqol	hyhyrkesusvoxqol
dibyz	didibyz
haba	hahaba
waqi	wawaqi
gop	gogop
nahco	nanahco
forton	foforton
zacugigcygxon	zazacugigcygxon
sepja	sesepja
siwrapcif	sisiwrapcif
maco	mamaco
luxu	luluxu
diro	didiro
gykryxi	gygykryxi
xamrif	xaxamrif
qiqykfasciqby	qiqiqykfasciqby
muhcypihqik	mumuhcypihqik
gawtis	gagawtis
casbexmupnew	cacasbexmupnew
qimniccug	qiqimniccug
xogsipko	xoxogsipko
koq	kokoq
tojget	totojget
bakejahvi	babakejahvi
pyhyl	pypyhyl
fogvag	fofogvag
zyvke	zyzyvke
hyvca	hyhyvca
kexci	kekexci
lepa	lelepa
xerosbybder	xexerosbybder
bomyv	bobomyv
gyl	gygyl
muszi	mumuszi
jarwatjexgeb	jajarwatjexgeb
rap	rarap
weqfuravefoz	weweqfuravefoz
vixywre	vivixywre
batag	babatag
teqartimyj	teteqartimyj
bunefcasuqad	bubunefcasuqad
fixiw	fifixiw
suvdu	susuvdu
fehwojqenwume	fefehwojqenwume
gopup	gogopup
sese	sesese
veppudnaq	veveppudnaq
vylyru	vyvylyru
fohnuqmy	fofohnuqmy
dununwe	dudununwe
zojty	zozojty
kilrim	kikilrim
nojqivypebpad	nonojqivypebpad
toscydir	totoscydir
lorajaxakov	lolorajaxakov
nefbel	nenefbel
ziloci	ziziloci
synsuh	sysynsuh
raxra	raraxra
hakubirsovyd	hahakubirsovyd
wysevwev	wywysevwev
najgyferla	nanajgyferla
xabbuv	xaxabbuv
vijka	vivijka
jupyzinimjes	jujupyzinimjes
fifte	fififte
roba	roroba
zym	zyzym
mojehoboq	momojehoboq
dan	dadan
guxypohmypa	guguxypohmypa
vudpyc	vuvudpyc
depgec	dedepgec
walqy	wawalqy
qaz	qaqaz
nebkid	nenebkid
buzundixjar	bubuzundixjar
gyc	gygyc
kuxpujgen	kukuxpujgen
nyrvucixlyfcy	nynyrvucixlyfcy
pudy	pupudy
jarlo	jajarlo
seqhohoh	seseqhohoh
wamfugfygrem	wawamfugfygrem
qegev	qeqegev
hegluv	hehegluv
xihegiwqejboz	xixihegiwqejboz
sumub	susumub
fexe	fefexe
xohjyskipu	xoxohjyskipu
jatgoci	jajatgoci
qiqepyzyzfyc	qiqiqepyzyzfyc
wusywem	wuwusywem
nakip	nanakip
fusdi	fufusdi
vym	vyvym
xojatci	xoxojatci
xylxupylehjul	xyxylxupylehjul
xemfolza	xexemfolza
kucjutuboc	kukucjutuboc
fusapzebwoqe	fufusapzebwoqe
kemzuza	kekemzuza
lonju	lolonju
byjpuq	bybyjpuq
gyzuhrikxici	gygyzuhrikxici
zifqyr	zizifqyr
vasenyfguref	vavasenyfguref
midoxo	mimidoxo
memor	mememor
socmyg	sosocmyg
zycaxkaluqpy	zyzycaxkaluqpy
nojle	nonojle
nebquj	nenebquj
ripzisinyh	riripzisinyh
jyrcu	jyjyrcu
mihu	mimihu
hos	hohos
dabzehbyk	dadabzehbyk
divu	didivu
puce	pupuce
vepan	vevepan
xum	xuxum
wotvexin	wowotvexin
conu	coconu
soxdo	sosoxdo
godjokyl	gogodjokyl
cytocycli	cycytocycli
dodgixy	dododgixy
qofydjit	qoqofydjit
wongaxi	wowongaxi
pihoj	pipihoj
zazef	zazazef
zatu	zazatu
wejiqhaqjotze	wewejiqhaqjotze
hosfodnuf	hohosfodnuf
worjuc	woworjuc
tefenheg	tetefenheg
lyte	lylyte
huznidam	huhuznidam
xorolyp	xoxorolyp
heghuh	heheghuh
gyjguqag	gygyjguqag
dakyd	dadakyd
pohyjjyki	popohyjjyki
favtip	fafavtip
nybikge	nynybikge
laqy	lalaqy
wopymoq	wowopymoq
sulmo	susulmo
delbelzur	dedelbelzur
byru	bybyru
jyv	jyjyv
mine	mimine
sale	sasale
fera	fefera
cihse	cicihse
dovhuw	dodovhuw
lyxwaq	lylyxwaq
vysjov	vyvysjov
gihnoslig	gigihnoslig
jycte	jyjycte
suwqyb	susuwqyb
zinbakxo	zizinbakxo
figa	fifiga
cotkir	cocotkir
bijiw	bibijiw
vinaw	vivinaw
rotwug	rorotwug
laju	lalaju
naxqi	nanaxqi
zafo	zazafo
jolof	jojolof
hybqol	hyhybqol
kolac	kokolac
kycaj	kykycaj
byhypog	bybyhypog
dazxege	dadazxege
tuqexfowoz	tutuqexfowoz
xumu	xuxumu
sapap	sasapap
zejixawnab	zezejixawnab
sezy	sesezy
dad	dadad
zylukqy	zyzylukqy
lajgo	lalajgo
tys	tytys
hujdyz	huhujdyz
hetqykpiqpuc	hehetqykpiqpuc
pofonehpiwy	popofonehpiwy
xif	xixif
lum	lulum
fowyz	fofowyz
pelrublifo	pepelrublifo
gige	gigige
dogefu	dodogefu
vur	vuvur
dasnazpet	dadasnazpet
refvy	rerefvy
gejafe	gegejafe
vetlirlitufy	vevetlirlitufy
kotu	kokotu
xifabek	xixifabek
foktipysqeno	fofoktipysqeno
rutydfefuso	rurutydfefuso
dafy	dadafy
kelefyk	kekelefyk
nikyko	ninikyko
diqub	didiqub
qobi	qoqobi
jidudag	jijidudag
gipqohqefhi	gigipqohqefhi
xufy	xuxufy
viqo	viviqo
vopnyw	vovopnyw
cygvim	cycygvim
hanofvo	hahanofvo
xujhy	xuxujhy
gibycyse	gigibycyse
pimet	pipimet
zivitboveg	zizivitboveg
dibsambenzurtyr	didibsambenzurtyr
xupfutihlov	xuxupfutihlov
mytodu	mymytodu
qilu	qiqilu
rokba	rorokba
tazzo	tatazzo
jywag	jyjywag
xatvas	xaxatvas
zelawdex	zezelawdex
jygasik	jyjygasik
gulicifjosa	gugulicifjosa
xihi	xixihi
hajomvedjunrud	hahajomvedjunrud
wyner	wywyner
gesyflyn	gegesyflyn
modse	momodse
kergubus	kekergubus
caxun	cacaxun
pugus	pupugus
bywwew	bybywwew
qysumavnydos	qyqysumavnydos
kopurohvy	kokopurohvy
parnysbe	paparnysbe
varidvubomu	vavaridvubomu
pepixy	pepepixy
himgu	hihimgu
qohogrij	qoqohogrij
jibpejbohynse	jijibpejbohynse
hotore	hohotore
hymqu	hyhymqu
saljy	sasaljy
mynuz	mymynuz
wife	wiwife
biznande	bibiznande
julok	jujulok
qydfil	qyqydfil
nafuco	nanafuco
pima	pipima
vodcoxposwa	vovodcoxposwa
jafduj	jajafduj
lawnilla	lalawnilla
ticuja	titicuja
sevec	sesevec
debi	dedebi
fical	fifical
qyhvad	qyqyhvad
muqede	mumuqede
pylul	pypylul
rivfykuq	ririvfykuq
hejy	hehejy
rufvy	rurufvy
deqehyd	dedeqehyd
qog	qoqog
bajxi	babajxi
jecy	jejecy
vonnolwus	vovonnolwus
kacfify	kakacfify
gyzvupis	gygyzvupis
logfur	lologfur
nym	nynym
nokym	nonokym
dijtoz	didijtoz
qaqitzivy	qaqaqitzivy
fehehdyxu	fefehehdyxu
xozjyx	xoxozjyx
jecjak	jejecjak
xykis	xyxykis
lehi	lelehi
vobdi	vovobdi
jamaq	jajamaq
meli	memeli
jowom	jojowom
penu	pepenu
juvxuz	jujuvxuz
tukjuvtisgoxe	tutukjuvtisgoxe
babe	bababe
kippewzo	kikippewzo
gym	gygym
vuwi	vuvuwi
gutezedigyt	gugutezedigyt
bewopzuresy	bebewopzuresy
qipamu	qiqipamu
copot	cocopot
wawculfymviqxyf	wawawculfymviqxyf
xicwekapycep	xixicwekapycep
gybki	gygybki
vameb	vavameb
rizug	ririzug
jalto	jajalto
xidu	xixidu
rotozymsa	rorotozymsa
xave	xaxave
vymsazag	vyvymsazag
zomu	zozomu
gelvifi	gegelvifi
hofufavuc	hohofufavuc
jysnyctyk	jyjysnyctyk
xopmex	xoxopmex
nydri	nynydri
sorhyvyxudwu	sosorhyvyxudwu
qepy	qeqepy
tate	tatate
wugxulxen	wuwugxulxen
netnynzukqypy	nenetnynzukqypy
puqmokec	pupuqmokec
nyhah	nynyhah
mecsekodqizo	memecsekodqizo
pimixyl	pipimixyl
xigwuzujgidjux	xixigwuzujgidjux
fivvuwol	fifivvuwol
cyzdu	cycyzdu
waty	wawaty
xumyt	xuxumyt
boltysydpoto	boboltysydpoto
tamah	tatamah
jewjiv	jejewjiv
lysyk	lylysyk
sesik	sesesik
guryqeboclep	guguryqeboclep
wigtet	wiwigtet
dyh	dydyh
gaquq	gagaquq
xuxahpi	xuxuxahpi
sused	susused
pywusitcyjti	pypywusitcyjti
tokqujo	totokqujo
hixruqo	hihixruqo
welid	wewelid
holiv	hoholiv
hoxucmuqwyr	hohoxucmuqwyr
masgac	mamasgac
quqhac	ququqhac
jovmotiv	jojovmotiv
byxa	bybyxa
xixho	xixixho
pyjxyn	pypyjxyn
sowyh	sosowyh
wywtonceloza	wywywtonceloza
jamkus	jajamkus
pahut	papahut
sixa	sisixa
gumbipcele	gugumbipcele
vawypno	vavawypno
hafylzug	hahafylzug
jadnaz	jajadnaz
vyxe	vyvyxe
jakco	jajakco
wakqo	wawakqo
xibat	xixibat
geq	gegeq
qunylgofefve	ququnylgofefve
ryzba	ryryzba
moxarlikil	momoxarlikil
kipligzelazoz	kikipligzelazoz
myvy	mymyvy
hudrypixce	huhudrypixce
vobzy	vovobzy
dugu	dudugu
cyze	cycyze
xuzrejykoba	xuxuzrejykoba
fejmejjer	fefejmejjer
telzy	tetelzy
qikzic	qiqikzic
hovwazyjku	hohovwazyjku
tezso	tetezso
femi	fefemi
xodguw	xoxodguw
vuly	vuvuly
qigqo	qiqigqo
xilmenesuxna	xixilmenesuxna
wuwurojvojrub	wuwuwurojvojrub
zah	zazah
gizwynhu	gigizwynhu
qanfermadhi	qaqanfermadhi
luxtude	luluxtude
wusurowohaz	wuwusurowohaz
xakgapvyqohxo	xaxakgapvyqohxo
hiwym	hihiwym
xyjoq	xyxyjoq
xybjy	xyxybjy
bezonuq	bebezonuq
morol	momorol
paci	papaci
fuveti	fufuveti
bajymcidugib	babajymcidugib
mosyrisne	momosyrisne
wehbe	wewehbe
kivomsemputruw	kikivomsemputruw
bekovdugu	bebekovdugu
jalvedi	jajalvedi
duha	duduha
qarsy	qaqarsy
pacsogyjxu	papacsogyjxu
bapu	babapu
botwix	bobotwix
javiwyqyknu	jajaviwyqyknu
tazsa	tatazsa
naq	nanaq
fili	fifili
vimarovos	vivimarovos
ruffa	ruruffa
juvajig	jujuvajig
qixtimga	qiqixtimga
sufvyd	susufvyd
junvazbac	jujunvazbac
zopof	zozopof
pefmaba	pepefmaba
tectut	tetectut
kucik	kukucik
wec	wewec
zymoraleskew	zyzymoraleskew
zukoxbela	zuzukoxbela
wesme	wewesme
nizvynedjel	ninizvynedjel
wartyf	wawartyf
wobso	wowobso
nymimojrurki	nynymimojrurki
wurleqrequm	wuwurleqrequm
vadlevpykxewu	vavadlevpykxewu
sysynotyd	sysysynotyd
nyj	nynyj
dehrolux	dedehrolux
xupuzyb	xuxupuzyb
jahihlov	jajahihlov
qibpezdo	qiqibpezdo
zegagu	zezegagu
zukakovax	zuzukakovax
nyjzyn	nynyjzyn
dus	dudus
rivwud	ririvwud
cyvoqoxilka	cycyvoqoxilka
jozdupi	jojozdupi
zovamrin	zozovamrin
nyxgo	nynyxgo
jaxsifcimkomtun	jajaxsifcimkomtun
jazhyno	jajazhyno
rocgi	rorocgi
waslad	wawaslad
fenok	fefenok
zohmoz	zozohmoz
saweg	sasaweg
dyvus	dydyvus
lexcod	lelexcod
tegzexorkotog	tetegzexorkotog
fimov	fifimov
domfiwcih	dodomfiwcih
bucir	bubucir
duvde	duduvde
qag	qaqag
vitdox	vivitdox
wogy	wowogy
rebgohsizylse	rerebgohsizylse
vuwowmol	vuvuwowmol
lody	lolody
wixgu	wiwixgu
nohpa	nonohpa
lewij	lelewij
jarcot	jajarcot
jakohejvedy	jajakohejvedy
wulcav	wuwulcav
tydna	tytydna
nedel	nenedel
lunyly	lulunyly
ryxoreb	ryryxoreb
qysoh	qyqysoh
kadhet	kakadhet
vifunxo	vivifunxo
myve	mymyve
wewi	wewewi
lexcownaq	lelexcownaq
luta	luluta
nygxanju	nynygxanju
nitim	ninitim
gufynnenjix	gugufynnenjix
zidnoqroglun	zizidnoqroglun
lyhpet	lylyhpet
zobpa	zozobpa
filmeci	fifilmeci
guhoto	guguhoto
wymdev	wywymdev
zecurdapav	zezecurdapav
gudsehexykdap	gugudsehexykdap
dizota	didizota
myc	mymyc
leqixa	leleqixa
xoj	xoxoj
tejjekbo	tetejjekbo
cyczud	cycyczud
wuggev	wuwuggev
nyqfatut	nynyqfatut
myqy	mymyqy
wuf	wuwuf
wybu	wywybu
xygne	xyxygne
mukpyz	mumukpyz
dazeq	dadazeq
zyjujzy	zyzyjujzy
jolfikulucjug	jojolfikulucjug
tysahakeh	tytysahakeh
qumpar	ququmpar
cewyhivpadoh	cecewyhivpadoh
tyjelbyx	tytyjelbyx
byfi	bybyfi
rymal	ryrymal
fawfa	fafawfa
sevemeq	sesevemeq
duhhi	duduhhi
xalpetwycuhtu	xaxalpetwycuhtu
favi	fafavi
zynheqvuky	zyzynheqvuky
zedzokus	zezedzokus
xowim	xoxowim
tobo	totobo
qexiz	qeqexiz
fifquf	fififquf
kikhe	kikikhe
jitvizsoq	jijitvizsoq
fynlawyxvem	fyfynlawyxvem
mupzosbucik	mumupzosbucik
jupvyvunuvi	jujupvyvunuvi
zalusij	zazalusij
hapiqjoxbozty	hahapiqjoxbozty
famewfe	fafamewfe
zyno	zyzyno
dofruvcezyt	dodofruvcezyt
wackeknamu	wawackeknamu
cyky	cycyky
wyhquj	wywyhquj
xikwu	xixikwu
vyjwysebked	vyvyjwysebked
jub	jujub
timmivjy	titimmivjy
gyvxo	gygyvxo
myfhetbetficu	mymyfhetbetficu
mixer	mimixer
cuqevebem	cucuqevebem
hewsipnyka	hehewsipnyka
jixeqigsejmi	jijixeqigsejmi
pixronomanum	pipixronomanum
jeflarji	jejeflarji
nuwjiguq	nunuwjiguq
fihal	fifihal
pikcipjux	pipikcipjux
pov	popov
fyho	fyfyho
dozy	dodozy
cylvy	cycylvy
vycmu	vyvycmu
xyhxu	xyxyhxu
sywwu	sysywwu
cazaw	cacazaw
fuwi	fufuwi
vabmik	vavabmik
zemo	zezemo
doppebrapygfap	dodoppebrapygfap
vadbo	vavadbo
fyxpiwcylal	fyfyxpiwcylal
der	deder
xupyq	xuxupyq
qobihek	qoqobihek
wysvuqexho	wywysvuqexho
byn	bybyn
tygta	tytygta
cumkew	cucumkew
kojucu	kokojucu
kyxo	kykyxo
cagfocyva	cacagfocyva
heqni	heheqni
bamle	babamle
zuvku	zuzuvku
lobjar	lolobjar
vuwtapsif	vuvuwtapsif
biq	bibiq
qulrazun	ququlrazun
putzohpy	puputzohpy
zyb	zyzyb
jusivajojyh	jujusivajojyh
xasliza	xaxasliza
piqxo	pipiqxo
cidwe	cicidwe
lanof	lalanof
luja	luluja
cutbata	cucutbata
lygebjaqfyzna	lylygebjaqfyzna
vypdag	vyvypdag
mytwyl	mymytwyl
gixxe	gigixxe
gury	gugury
xahubuh	xaxahubuh
sexowijgeg	sesexowijgeg
dijyv	didijyv
rezew	rerezew
macnudzof	mamacnudzof
vimzak	vivimzak
xekiriteb	xexekiriteb
gybeb	gygybeb
mefo	memefo
sozoqi	sosozoqi
wit	wiwit
xoquz	xoxoquz
viwfu	viviwfu
susal	sususal
maj	mamaj
xufiglo	xuxufiglo
kynqeqpi	kykynqeqpi
lupkeb	lulupkeb
xohvogcuk	xoxohvogcuk
xuzpumke	xuxuzpumke
ziwmuf	ziziwmuf
rasmib	rarasmib
dymu	dydymu
roku	roroku
pihqaq	pipihqaq
rykefafyl	ryrykefafyl
bygom	bybygom
syhmot	sysyhmot
qaxwa	qaqaxwa
mylwuxzevsus	mymylwuxzevsus
vohbaz	vovohbaz
xonny	xoxonny
sescopnypbe	sesescopnypbe
zukam	zuzukam
gelaxjysur	gegelaxjysur
nubos	nunubos
pahak	papahak
jyfakijixfu	jyjyfakijixfu
qigda	qiqigda
boroq	boboroq
munagam	mumunagam
jorcuhih	jojorcuhih
nytqehu	nynytqehu
xoqa	xoxoqa
vodjiza	vovodjiza
pagsomowoce	papagsomowoce
xezujzylunxi	xexezujzylunxi
miqnovcyhuwsa	mimiqnovcyhuwsa
nok	nonok
fubho	fufubho
zac	zazac
disu	didisu
fobecmig	fofobecmig
vax	vavax
qilarybra	qiqilarybra
bybhi	bybybhi
dop	dodop
foxki	fofoxki
ceko	ceceko
hah	hahah
gewi	gegewi
xupwewarpaniz	xuxupwewarpaniz
zymy	zyzymy
juqokoz	jujuqokoz
vogo	vovogo
zuryxge	zuzuryxge
pojqek	popojqek
vumecodopfon	vuvumecodopfon
gycle	gygycle
nasijrofxywmy	nanasijrofxywmy
habtu	hahabtu
tisjid	titisjid
vatwyvvican	vavatwyvvican
jumpyw	jujumpyw
qyjryhonergy	qyqyjryhonergy
qoxwiz	qoqoxwiz
rogper	rorogper
ryjy	ryryjy
dywe	dydywe
gyqijcyp	gygyqijcyp
rydvudqifixdoh	ryrydvudqifixdoh
sofuwtym	sosofuwtym
qejuf	qeqejuf
huqlacgi	huhuqlacgi
zavycxaz	zazavycxaz
gihdybzoxad	gigihdybzoxad
zan	zazan
becy	bebecy
hykivkuzo	hyhykivkuzo
hinodoh	hihinodoh
nuhejjihery	nunuhejjihery
dyxeb	dydyxeb
julerycxesvu	jujulerycxesvu
tedup	tetedup
lav	lalav
micuc	mimicuc
jeref	jejeref
jolmabpowup	jojolmabpowup
mepqu	memepqu
sokuvyr	sosokuvyr
bujudtab	bubujudtab
far	fafar
xibi	xixibi
petu	pepetu
celosloj	cecelosloj
kalqizqule	kakalqizqule
fymy	fyfymy
duli	duduli
zexebfus	zezexebfus
qixe	qiqixe
buted	bubuted
qece	qeqece
quzlefaxox	ququzlefaxox
huqlevihsamhih	huhuqlevihsamhih
jowpuc	jojowpuc
fuvjyg	fufuvjyg
xuqix	xuxuqix
laxa	lalaxa
vaxtax	vavaxtax
nigrunylre	ninigrunylre
zarethykymy	zazarethykymy
zejsekime	zezejsekime
dulzuritrog	dudulzuritrog
kykuzo	kykykuzo
kovy	kokovy
gus	gugus
gotxekdidep	gogotxekdidep
sidqigejgo	sisidqigejgo
sydruz	sysydruz
cetrizuk	cecetrizuk
rikfevxotycgo	ririkfevxotycgo
huzgoq	huhuzgoq
dandude	dadandude
comij	cocomij
tenjuq	tetenjuq
qakhiwru	qaqakhiwru
ruz	ruruz
camykufysy	cacamykufysy
levol	lelevol
vudfubyt	vuvudfubyt
jyba	jyjyba
mumlyhyv	mumumlyhyv
jyg	jyjyg
tydyw	tytydyw
tem	tetem
kyccuh	kykyccuh
jutjo	jujutjo
licapuxsy	lilicapuxsy
duva	duduva
detbyc	dedetbyc
fitvy	fifitvy
kizeqhazut	kikizeqhazut
jarnumjy	jajarnumjy
bycorpatyd	bybycorpatyd
tadzof	tatadzof
documjopyhy	dodocumjopyhy
luritha	luluritha
mosfok	momosfok
gytyxub	gygytyxub
ryf	ryryf
byqkag	bybyqkag
vomeffok	vovomeffok
muxjud	mumuxjud
gigmu	gigigmu
haspustyc	hahaspustyc
fyvqa	fyfyvqa
zodwef	zozodwef
mokabuq	momokabuq
codu	cocodu
ruccif	ruruccif
wamu	wawamu
mihehfet	mimihehfet
jyconuf	jyjyconuf
wyj	wywyj
dimunge	didimunge
xefriqucjyxwuh	xexefriqucjyxwuh
xizym	xixizym
sibzuz	sisibzuz
dylwe	dydylwe
vyfamiq	vyvyfamiq
mysy	mymysy
xehruge	xexehruge
ribzek	riribzek
cykxo	cycykxo
kef	kekef
tis	titis
kabafpetponbe	kakabafpetponbe
xilmygji	xixilmygji
vihsecwew	vivihsecwew
dytbyd	dydytbyd
lihit	lilihit
saziza	sasaziza
zykqulyhjac	zyzykqulyhjac
duwis	duduwis
terwiko	teterwiko
jibnygmyrurqac	jijibnygmyrurqac
zes	zezes
javroq	jajavroq
jobyvboxas	jojobyvboxas
nabwotuqfakpog	nanabwotuqfakpog
kydvyzmolmuq	kykydvyzmolmuq
gygytziqeqcem	gygygytziqeqcem
hedarbyhnop	hehedarbyhnop
lidkeqdixi	lilidkeqdixi
dygmeme	dydygmeme
tufy	tutufy
mafaw	mamafaw
vumek	vuvumek
tadajfamwy	tatadajfamwy
huhxu	huhuhxu
toto	tototo
kyp	kykyp
wadegi	wawadegi
varde	vavarde
gysec	gygysec
libpypweteqoq	lilibpypweteqoq
bazdid	babazdid
jarov	jajarov
mozbug	momozbug
ceqo	ceceqo
maful	mamaful
qaghupdurujyn	qaqaghupdurujyn
qyfebave	qyqyfebave
dirif	didirif
sajkun	sasajkun
fowog	fofowog
lofwi	lolofwi
xahar	xaxahar
bodwoqapxa	bobodwoqapxa
mavkiknyk	mamavkiknyk
jisvecuz	jijisvecuz
faqixudafiw	fafaqixudafiw
cohadef	cocohadef
vupuchaq	vuvupuchaq
jorofeg	jojorofeg
wawgyl	wawawgyl
tihyboji	titihyboji
pahqekjikum	papahqekjikum
qusgep	ququsgep
cewtyt	cecewtyt
poqu	popoqu
qunufter	ququnufter
fota	fofota
leq	leleq
suxfix	susuxfix
nome	nonome
ryhu	ryryhu
wyluhyj	wywyluhyj
mapypur	mamapypur
tuce	tutuce
cyvcudeq	cycyvcudeq
qimko	qiqimko
zozatymal	zozozatymal
luffyl	luluffyl
jikumvexxahaj	jijikumvexxahaj
huxoj	huhuxoj
vyguwu	vyvyguwu
tunrut	tutunrut
nil	ninil
hycog	hyhycog
lykcuxtynisen	lylykcuxtynisen
fyhviwwe	fyfyhviwwe
vemogso	vevemogso
picun	pipicun
tosawcu	totosawcu
jidkuji	jijidkuji
gadpivbi	gagadpivbi
vuwy	vuvuwy
wyhalojla	wywyhalojla
lowjuzit	lolowjuzit
zuhdojtepsofi	zuzuhdojtepsofi
turtogxebsapmu	tuturtogxebsapmu
cagob	cacagob
xuwo	xuxuwo
rysane	ryrysane
tojvigjif	totojvigjif
syc	sysyc
dem	dedem
hynmer	hyhynmer
vivumywahwuj	vivivumywahwuj
jypangov	jyjypangov
zalwy	zazalwy
wek	wewek
pacxe	papacxe
zusygytfumoc	zuzusygytfumoc
gyk	gygyk
xiku	xixiku
pobloj	popobloj
qar	qaqar
ral	raral
qaje	qaqaje
xubwisobko	xuxubwisobko
lesqis	lelesqis
fyculcel	fyfyculcel
fokba	fofokba
vawca	vavawca
hidopsuqengid	hihidopsuqengid
nubqok	nunubqok
rilzimri	ririlzimri
xukaf	xuxukaf
sihdufy	sisihdufy
raqybnejago	raraqybnejago
cal	cacal
vonwah	vovonwah
metyf	memetyf
wyzalmy	wywyzalmy
dokfycku	dodokfycku
xorajaj	xoxorajaj
xep	xexep
nuwgywnos	nunuwgywnos
lir	lilir
jitun	jijitun
mojwu	momojwu
cybydzyzaw	cycybydzyzaw
ticmetqu	titicmetqu
zunaf	zuzunaf
wun	wuwun
gidijar	gigidijar
pegom	pepegom
syjy	sysyjy
foked	fofoked
rysat	ryrysat
ryxjyjvecowam	ryryxjyjvecowam
popu	popopu
qurynde	ququrynde
boppycmuragxyf	boboppycmuragxyf
zuxo	zuzuxo
nuva	nunuva
guc	guguc
bygwi	bybygwi
tecpi	tetecpi
rofvu	rorofvu
wyqem	wywyqem
xoqqi	xoxoqqi
ginrum	giginrum
cugtat	cucugtat
xaboq	xaxaboq
lyhem	lylyhem
mixinge	mimixinge
viw	viviw
qifnicow	qiqifnicow
fuwdera	fufuwdera
hofoxratzus	hohofoxratzus
ryjyh	ryryjyh
cuby	cucuby
jajylmyhycku	jajajylmyhycku
fafiwati	fafafiwati
rimzazlu	ririmzazlu
qocjyluf	qoqocjyluf
corqyd	cocorqyd
bugda	bubugda
rifu	ririfu
tibuzatbo	titibuzatbo
qylu	qyqylu
vistabji	vivistabji
jokilas	jojokilas
julurextigek	jujulurextigek
herzik	heherzik
gipar	gigipar
ryn	ryryn
sudixuma	susudixuma
fylgen	fyfylgen
rucoz	rurucoz
pyqfef	pypyqfef
wejwu	wewejwu
huqdis	huhuqdis
doxpoz	dodoxpoz
gulmegiqqefvol	gugulmegiqqefvol
jexifyrkejvi	jejexifyrkejvi
tipqube	titipqube
riviqibatu	ririviqibatu
vexis	vevexis
damhy	dadamhy
perodxunfavton	peperodxunfavton
cefakcojtefviq	cecefakcojtefviq
pajaq	papajaq
lebakajunqur	lelebakajunqur
jiqlopcyroqwir	jijiqlopcyroqwir
jewpalmanbo	jejewpalmanbo
cuto	cucuto
kynis	kykynis
xubevasafym	xuxubevasafym
qucugho	ququcugho
zugfywugy	zuzugfywugy
gytden	gygytden
kigyjliklu	kikigyjliklu
boqzuf	boboqzuf
musbedfe	mumusbedfe
pojmuxjiqev	popojmuxjiqev
fozdonumkowsu	fofozdonumkowsu
vimon	vivimon
xagja	xaxagja
xunrybigiq	xuxunrybigiq
ryda	ryryda
wynufor	wywynufor
tociboh	totociboh
sindypsoza	sisindypsoza
qonmulbos	qoqonmulbos
wozuzsax	wowozuzsax
cajte	cacajte
rufuso	rurufuso
fosca	fofosca
vetqelap	vevetqelap
jinyvvespam	jijinyvvespam
pawfu	papawfu
jicyxwitacci	jijicyxwitacci
kixvy	kikixvy
bawyse	babawyse
fysyga	fyfysyga
wytwozjozlebce	wywytwozjozlebce
zebi	zezebi
puwy	pupuwy
ledynge	leledynge
holluk	hoholluk
dapuny	dadapuny
vupup	vuvupup
zakkec	zazakkec
dicpyngyhpir	didicpyngyhpir
qyclommycjy	qyqyclommycjy
hunejuvqoqi	huhunejuvqoqi
wujfeqotzegi	wuwujfeqotzegi
wuxu	wuwuxu
gusamegannod	gugusamegannod
gusujy	gugusujy
mylfi	mymylfi
midadkena	mimidadkena
pochi	popochi
mocedohsu	momocedohsu
mihpe	mimihpe
wepxu	wewepxu
wopyw	wowopyw
mito	mimito
wavruterudra	wawavruterudra
nunopfa	nununopfa
kego	kekego
moxysy	momoxysy
zisci	zizisci
son	soson
nebinsy	nenebinsy
parky	paparky
vevsapylykpe	vevevsapylykpe
kyhe	kykyhe
budzuh	bubudzuh
hafin	hahafin
seqogwyqoq	seseqogwyqoq
qofiv	qoqofiv
lepqin	lelepqin
kyr	kykyr
muvki	mumuvki
wuzojfycyvca	wuwuzojfycyvca
bolguf	bobolguf
dekqol	dedekqol
lufil	lulufil
kygu	kykygu
gobbosito	gogobbosito
symi	sysymi
butaq	bubutaq
hodqonenhoje	hohodqonenhoje
lozef	lolozef
vyreb	vyvyreb
zibikxo	zizibikxo
mimdy	mimimdy
japat	jajapat
gofovotmafij	gogofovotmafij
rinrughas	ririnrughas
xafyxah	xaxafyxah
cewogtog	cecewogtog
ceclo	cececlo
terib	teterib
dixmojabiko	didixmojabiko
xyg	xyxyg
jema	jejema
jabig	jajabig
humek	huhumek
tucpyp	tutucpyp
tirsu	titirsu
dal	dadal
himdotafwuczi	hihimdotafwuczi
tov	totov
robewe	rorobewe
buci	bubuci
niq	niniq
qisi	qiqisi
datik	dadatik
didboqadduc	dididboqadduc
zorfyzic	zozorfyzic
gatzyfdegtypuq	gagatzyfdegtypuq
xarnadxib	xaxarnadxib
wonmik	wowonmik
jomlyh	jojomlyh
xenoxhen	xexenoxhen
zepa	zezepa
xizid	xixizid
lafxyt	lalafxyt
vusil	vuvusil
biluz	bibiluz
mawci	mamawci
xafy	xaxafy
tesba	tetesba
kiciw	kikiciw
vowo	vovowo
hini	hihini
pinabodepej	pipinabodepej
rixlitjacibqaw	ririxlitjacibqaw
dawik	dadawik
tirerkimugma	titirerkimugma
hyrxil	hyhyrxil
byroz	bybyroz
zemgocopfo	zezemgocopfo
deqeh	dedeqeh
lectas	lelectas
kanhyhlis	kakanhyhlis
kucenolyrlup	kukucenolyrlup
zegjusor	zezegjusor
hylug	hyhylug
waxvycyhbon	wawaxvycyhbon
waxluq	wawaxluq
zav	zazav
lybqyczymyb	lylybqyczymyb
qecysy	qeqecysy
kucza	kukucza
laqorehroq	lalaqorehroq
gancybiqkamom	gagancybiqkamom
wypsexfylygij	wywypsexfylygij
vavluvyphynup	vavavluvyphynup
xilfa	xixilfa
bagoj	babagoj
fujryv	fufujryv
gyhhyhnec	gygyhhyhnec
tazlyr	tatazlyr
legrojoqame	lelegrojoqame
jaxci	jajaxci
zesuju	zezesuju
vudedyz	vuvudedyz
fejtukyhor	fefejtukyhor
lurcon	lulurcon
fuq	fufuq
qygzumu	qyqygzumu
tawnon	tatawnon
muwun	mumuwun
rirzyp	ririrzyp
tofma	totofma
kunzevmapmugak	kukunzevmapmugak
pofqyw	popofqyw
cuqaluhyh	cucuqaluhyh
coggu	cocoggu
vajsepto	vavajsepto
wacbav	wawacbav
fynbux	fyfynbux
fyfam	fyfyfam
sab	sasab
ruxcyh	ruruxcyh
luzij	luluzij
rufkowfaxeda	rurufkowfaxeda
bube	bubube
dapo	dadapo
qotrulit	qoqotrulit
bucita	bubucita
wugy	wuwugy
rovraj	rorovraj
rocaxadko	rorocaxadko
race	rarace
bem	bebem
lamyzcem	lalamyzcem
xuk	xuxuk
pihozef	pipihozef
tefhe	tetefhe
cygtipveclibuf	cycygtipveclibuf
tarug	tatarug
tinadetydhog	titinadetydhog
vonxojvil	vovonxojvil
fikitijvob	fifikitijvob
xemu	xexemu
mig	mimig
kyvycyhyr	kykyvycyhyr
qonduxuhnisih	qoqonduxuhnisih
sowqik	sosowqik
jawtawton	jajawtawton
mabem	mamabem
jorgol	jojorgol
jivyr	jijivyr
runren	rurunren
xidi	xixidi
lex	lelex
bazwa	babazwa
qyf	qyqyf
gesufi	gegesufi
xixpyc	xixixpyc
vajfycakkubgoj	vavajfycakkubgoj
vojildumixbar	vovojildumixbar
jaqu	jajaqu
hilorsingiwal	hihilorsingiwal
her	heher
tebzyracyvky	tetebzyracyvky
birhagekcusfu	bibirhagekcusfu
merwovfo	memerwovfo
viqzevna	viviqzevna
samys	sasamys
syb	sysyb
wupve	wuwupve
wochux	wowochux
pywys	pypywys
homepu	hohomepu
ragyharneqpy	raragyharneqpy
lyxigsud	lylyxigsud
tacxys	tatacxys
wyjaw	wywyjaw
zikjydfel	zizikjydfel
kycmeckapeza	kykycmeckapeza
felo	fefelo
gomharyq	gogomharyq
pygab	pypygab
dolmugji	dodolmugji
tazfy	tatazfy
wotapfedysvu	wowotapfedysvu
nyvdyfta	nynyvdyfta
xovga	xoxovga
jutep	jujutep
dis	didis
faqa	fafaqa
tac	tatac
zytlotvibvamy	zyzytlotvibvamy
dajohe	dadajohe
zulbok	zuzulbok
xejyjwepgoneq	xexejyjwepgoneq
niz	niniz
jymhemowuw	jyjymhemowuw
vyxicy	vyvyxicy
maqa	mamaqa
hilynib	hihilynib
neke	neneke
vylduqpy	vyvylduqpy
surazremi	susurazremi
kehyxu	kekehyxu
xinyhawjut	xixinyhawjut
dur	dudur
damqiz	dadamqiz
lalrytqyznyqu	lalalrytqyznyqu
zik	zizik
getaxxe	gegetaxxe
zyse	zyzyse
wawyc	wawawyc
cedik	cecedik
lixyf	lilixyf
wilzeb	wiwilzeb
sesquqdidvinqy	sesesquqdidvinqy
wufcy	wuwufcy
jaxvyf	jajaxvyf
hehyfu	hehehyfu
vofolzusegxaw	vovofolzusegxaw
fowacoceqqoc	fofowacoceqqoc
low	lolow
pupiha	pupupiha
guzcoq	guguzcoq
zotxy	zozotxy
jinpi	jijinpi
sohum	sosohum
pakvun	papakvun
hergemwykge	hehergemwykge
wiqve	wiwiqve
recvewvydvof	rerecvewvydvof
huszetqigyh	huhuszetqigyh
pyho	pypyho
kijzaqybo	kikijzaqybo
mesar	memesar
sofdih	sosofdih
myj	mymyj
cihta	cicihta
bodgeco	bobodgeco
wad	wawad
gekawmyr	gegekawmyr
pydjobbelsemdi	pypydjobbelsemdi
pycfyrhondocy	pypycfyrhondocy
lilqi	lililqi
tefyj	tetefyj
visobja	vivisobja
woxi	wowoxi
hyl	hyhyl
dovyskegmu	dodovyskegmu
berdafnyxwe	beberdafnyxwe
vygem	vyvygem
kadwekocokdut	kakadwekocokdut
xoxjag	xoxoxjag
muwum	mumuwum
soqluqohki	sosoqluqohki
foxossugxy	fofoxossugxy
wijlywanlytaz	wiwijlywanlytaz
bexlalzisxa	bebexlalzisxa
lifi	lilifi
gevcy	gegevcy
kyvzobenjyzpuk	kykyvzobenjyzpuk
cigtuxjygej	cicigtuxjygej
zyvpytfu	zyzyvpytfu
tekeclo	tetekeclo
kaxgirili	kakaxgirili
nibkypehsehy	ninibkypehsehy
milatanad	mimilatanad
soccubadhykak	sosoccubadhykak
jucy	jujucy
jycsisulgol	jyjycsisulgol
fah	fafah
cygvolcuc	cycygvolcuc
cypuh	cycypuh
dijva	didijva
pajsagqiw	papajsagqiw
bobdi	bobobdi
hyhvu	hyhyhvu
dykmyg	dydykmyg
divim	didivim
xypybe	xyxypybe
siz	sisiz
wuril	wuwuril
putfivalpi	puputfivalpi
hopjugeni	hohopjugeni
gyleh	gygyleh
laroli	lalaroli
bymqypnyspyfjez	bybymqypnyspyfjez
vet	vevet
bahev	babahev
xaxko	xaxaxko
zihow	zizihow
zibyfevgy	zizibyfevgy
lenlilibvo	lelenlilibvo
zicekca	zizicekca
hahix	hahahix
kofukyhoxu	kokofukyhoxu
dehiq	dedehiq
qaq	qaqaq
zervos	zezervos
mytzy	mymytzy
benynryzi	bebenynryzi
pilxat	pipilxat
qibutqi	qiqibutqi
haqylkyvro	hahaqylkyvro
xap	xaxap
pydynxazmekan	pypydynxazmekan
liwkoqcybamet	liliwkoqcybamet
tokovuj	totokovuj
vazofcot	vavazofcot
jafy	jajafy
fog	fofog
pykur	pypykur
fadki	fafadki
tirpiv	titirpiv
quxylihraryn	ququxylihraryn
kimevuw	kikimevuw
nexvyq	nenexvyq
rojilcygso	rorojilcygso
suqlowlevikon	susuqlowlevikon
feja	fefeja
dopoz	dodopoz
qecak	qeqecak
rinwikfaduw	ririnwikfaduw
rydijocnuc	ryrydijocnuc
wudga	wuwudga
cerorsor	cecerorsor
jusfi	jujusfi
gysytmi	gygysytmi
misobba	mimisobba
lad	lalad
xemzi	xexemzi
hekup	hehekup
hywho	hyhywho
roz	roroz
hajic	hahajic
lehnilutup	lelehnilutup
regad	reregad
suc	susuc
xonep	xoxonep
muw	mumuw
caxiromup	cacaxiromup
kalah	kakalah
refodovmo	rerefodovmo
jygjipbete	jyjygjipbete
tyztipuc	tytyztipuc
fescap	fefescap
tabnel	tatabnel
gawno	gagawno
duznecdu	duduznecdu
rydydychimky	ryrydydychimky
zuko	zuzuko
gojaz	gogojaz
zepuj	zezepuj
tuzag	tutuzag
javugtoja	jajavugtoja
neznec	neneznec
rapib	rarapib
geweh	gegeweh
nyze	nynyze
wyvatorem	wywyvatorem
gidexpekzuryj	gigidexpekzuryj
xoqikwebycur	xoxoqikwebycur
demqyq	dedemqyq
qagnutza	qaqagnutza
zovta	zozovta
baje	babaje
nurruqhezfosi	nunurruqhezfosi
bodywet	bobodywet
gufav	gugufav
mana	mamana
temrutdy	tetemrutdy
qedped	qeqedped
rynhe	ryrynhe
wygurqu	wywygurqu
vuvsin	vuvuvsin
vefu	vevefu
lynpose	lylynpose
cahiggi	cacahiggi
copurdy	cocopurdy
socotwu	sosocotwu
qicajnethuf	qiqicajnethuf
dipi	didipi
coxniwa	cocoxniwa
jobxox	jojobxox
wakkumcojmyc	wawakkumcojmyc
sabbih	sasabbih
zebmiw	zezebmiw
sofy	sosofy
hadizzemby	hahadizzemby
keqlugyg	kekeqlugyg
rizyswa	ririzyswa
nevlortu	nenevlortu
lilny	lililny
velzi	vevelzi
safyzorsidnol	sasafyzorsidnol
bomkentahi	bobomkentahi
bawny	babawny
kucdo	kukucdo
surny	susurny
dobhur	dodobhur
gezkasti	gegezkasti
zomgopy	zozomgopy
gegveg	gegegveg
survuk	susurvuk
tepylaw	tetepylaw
wuqhyqoc	wuwuqhyqoc
xevlog	xexevlog
zagimuf	zazagimuf
jijijvyc	jijijijvyc
hegxymhuqapca	hehegxymhuqapca
rosi	rorosi
makoqdiltu	mamakoqdiltu
hekxaj	hehekxaj
caduwdif	cacaduwdif
baf	babaf
kojonpi	kokojonpi
cohhaviq	cocohhaviq
zeccilxopnuny	zezeccilxopnuny
xicle	xixicle
bowsus	bobowsus
hip	hihip
lothynavko	lolothynavko
fidesmexed	fifidesmexed
duviribofy	duduviribofy
vafuternuxtu	vavafuternuxtu
giqmas	gigiqmas
cepodimku	cecepodimku
faxfaf	fafaxfaf
gywi	gygywi
cupig	cucupig
haj	hahaj
hap	hahap
mybmozpo	mymybmozpo
pakfev	papakfev
sequb	sesequb
qivakcodqed	qiqivakcodqed
xafafwosoxi	xaxafafwosoxi
xevec	xexevec
rujruxa	rurujruxa
deztumqu	dedeztumqu
sisuqe	sisisuqe
gerkeq	gegerkeq
nypqiv	nynypqiv
jyso	jyjyso
niho	niniho
lepu	lelepu
tighovar	titighovar
qevjy	qeqevjy
hunforizku	huhunforizku
meskocvys	memeskocvys
taw	tataw
qacbocewyxic	qaqacbocewyxic
zyquqnejde	zyzyquqnejde
peruw	peperuw
gejoxqib	gegejoxqib
lebbyrbekoni	lelebbyrbekoni
kitix	kikitix
nuxjurupakaj	nunuxjurupakaj
xyqrysmyxyv	xyxyqrysmyxyv
moqezhyrjimdy	momoqezhyrjimdy
wixxa	wiwixxa
nuglynmah	nunuglynmah
huzyzbim	huhuzyzbim
zaxa	zazaxa
tawtaq	tatawtaq
qynqun	qyqynqun
vemac	vevemac
kincuzi	kikincuzi
gecibzo	gegecibzo
vavut	vavavut
xyzrybos	xyxyzrybos
gut	gugut
gadnurlygfa	gagadnurlygfa
gimubdec	gigimubdec
ralakbun	raralakbun
cuj	cucuj
wygal	wywygal
pimtaxkejmeqtej	pipimtaxkejmeqtej
tawi	tatawi
pihaq	pipihaq
gom	gogom
dajbo	dadajbo
higog	hihigog
fyco	fyfyco
bykkybok	bybykkybok
lujsernemuhup	lulujsernemuhup
ryza	ryryza
qihwe	qiqihwe
vaqe	vavaqe
myxry	mymyxry
wiwyb	wiwiwyb
xyponhigetxu	xyxyponhigetxu
zisaq	zizisaq
fyg	fyfyg
wegin	wewegin
luxax	luluxax
bakti	babakti
fihkefma	fifihkefma
xaswi	xaxaswi
dehuqesoddow	dedehuqesoddow
lyx	lylyx
zuwbegiv	zuzuwbegiv
huhi	huhuhi
mawwiniq	mamawwiniq
zipqu	zizipqu
mehsiv	memehsiv
pecho	pepecho
hofzojlahci	hohofzojlahci
hurwen	huhurwen
pimigsy	pipimigsy
hupib	huhupib
tadnon	tatadnon
quhsam	ququhsam
zawa	zazawa
mabfikkih	mamabfikkih
vexzul	vevexzul
kycymne	kykycymne
zykkehwyggyngy	zyzykkehwyggyngy
gixmamy	gigixmamy
jeptaspyfba	jejeptaspyfba
zike	zizike
dotaja	dodotaja
maqxik	mamaqxik
merhon	memerhon
luq	luluq
mexizu	memexizu
xotelne	xoxotelne
wesxowrujhuvfes	wewesxowrujhuvfes
wigpo	wiwigpo
puvcen	pupuvcen
deva	dedeva
cojgus	cocojgus
xydce	xyxydce
dylaclifnomig	dydylaclifnomig
nycjy	nynycjy
ryvgeduv	ryryvgeduv
feram	feferam
sytazna	sysytazna
rycakaq	ryrycakaq
jerotuc	jejerotuc
xyjy	xyxyjy
nodzicyf	nonodzicyf
sonul	sosonul
cajapov	cacajapov
hinujy	hihinujy
jetqofymezoj	jejetqofymezoj
zacvel	zazacvel
miqaf	mimiqaf
fogxonynly	fofogxonynly
tybcymnyse	tytybcymnyse
jucvar	jujucvar
vorzuw	vovorzuw
gyzwux	gygyzwux
wuxy	wuwuxy
nyzpigo	nynyzpigo
mucehsav	mumucehsav
deros	dederos
xiwby	xixiwby
zaqagbytat	zazaqagbytat
nascohonyne	nanascohonyne
jevacuta	jejevacuta
vupgulvydpoz	vuvupgulvydpoz
pacpije	papacpije
jyf	jyjyf
sefcasbi	sesefcasbi
guqowajodu	guguqowajodu
suhbaq	susuhbaq
dury	dudury
mixhaq	mimixhaq
joqzos	jojoqzos
ceve	ceceve
jyrryxceqiqdoc	jyjyrryxceqiqdoc
xudaqcequ	xuxudaqcequ
rynqy	ryrynqy
palhut	papalhut
pecigle	pepecigle
xabsunupcoh	xaxabsunupcoh
noggat	nonoggat
hanjux	hahanjux
quqe	ququqe
cagpum	cacagpum
hurhac	huhurhac
xadatiswopwy	xaxadatiswopwy
wicvol	wiwicvol
zilpe	zizilpe
kaftuje	kakaftuje
weqi	weweqi
xyluxdas	xyxyluxdas
sonos	sosonos
nuty	nunuty
razuwarlomgod	rarazuwarlomgod
vumox	vuvumox
nysywcag	nynysywcag
lejvojqizusgo	lelejvojqizusgo
mowzixukruf	momowzixukruf
teqe	teteqe
xessi	xexessi
sobowjoqwar	sosobowjoqwar
maxeqe	mamaxeqe
wara	wawara
fes	fefes
handev	hahandev
tosurih	totosurih
pyjfihqy	pypyjfihqy
sywkiqil	sysywkiqil
kynopreslybow	kykynopreslybow
puzror	pupuzror
byjdih	bybyjdih
roshegalo	roroshegalo
xoni	xoxoni
cexze	cecexze
vywijwur	vyvywijwur
nyfas	nynyfas
kexzopcos	kekexzopcos
rovryr	rorovryr
roqqojfoxhy	roroqqojfoxhy
fumof	fufumof
xukqibuh	xuxukqibuh
taqvoh	tataqvoh
lodpynkot	lolodpynkot
givxysonpe	gigivxysonpe
paqi	papaqi
fussylximyhtax	fufussylximyhtax
ditodykliho	diditodykliho
rehodo	rerehodo
begalylxaz	bebegalylxaz
gisjowugkojo	gigisjowugkojo
minwyrachy	miminwyrachy
kebyg	kekebyg
calhedmeramu	cacalhedmeramu
fuvigzo	fufuvigzo
jotri	jojotri
jantaru	jajantaru
pivoccijfa	pipivoccijfa
reza	rereza
fiqli	fifiqli
gucij	gugucij
cudi	cucudi
xeja	xexeja
pylpical	pypylpical
gyb	gygyb
sefxag	sesefxag
falinzyfyt	fafalinzyfyt
rusryn	rurusryn
hydpi	hyhydpi
hyq	hyhyq
jyfu	jyjyfu
kamle	kakamle
zirgav	zizirgav
xyzudakcasda	xyxyzudakcasda
gij	gigij
zaxuqyn	zazaxuqyn
qenutmyghadap	qeqenutmyghadap
conatpy	coconatpy
tinjixqydbykyg	titinjixqydbykyg
jyxtugvytqy	jyjyxtugvytqy
kyje	kykyje
nipde	ninipde
tafiv	tatafiv
nerij	nenerij
winhixe	wiwinhixe
nebwy	nenebwy
resxeturtytaf	reresxeturtytaf
ponyjimyqat	poponyjimyqat
zykcyw	zyzykcyw
niwohoqmek	niniwohoqmek
syzgicycse	sysyzgicycse
xabvil	xaxabvil
citti	cicitti
bifijgo	bibifijgo
qugilin	ququgilin
dajyqyx	dadajyqyx
tirpyntuqy	titirpyntuqy
tepob	tetepob
jexgykhufpu	jejexgykhufpu
zybpysivy	zyzybpysivy
camuj	cacamuj
pygmux	pypygmux
zytfanzu	zyzytfanzu
rubekhyq	rurubekhyq
zefli	zezefli
pirqux	pipirqux
vefy	vevefy
bumzo	bubumzo
gox	gogox
fyhu	fyfyhu
zysafu	zyzysafu
jovzevvoxqa	jojovzevvoxqa
hebomguj	hehebomguj
cacfewufo	cacacfewufo
sov	sosov
nusmod	nunusmod
vijcyge	vivijcyge
loz	loloz
roviq	roroviq
zerew	zezerew
hepumoh	hehepumoh
zykgex	zyzykgex
wuhvasizpi	wuwuhvasizpi
tysan	tytysan
wixbe	wiwixbe
rerjov	rererjov
sibcucahvomig	sisibcucahvomig
hylnanwigyquv	hyhylnanwigyquv
noc	nonoc
hulel	huhulel
ryrgi	ryryrgi
numxi	nunumxi
hudso	huhudso
xozry	xoxozry
vidititjaja	vividititjaja
qulacgoc	ququlacgoc
nicze	ninicze
wuclytcanradu	wuwuclytcanradu
lyto	lylyto
resejzaxuxgy	reresejzaxuxgy
gigys	gigigys
locelty	lolocelty
kaka	kakaka
zywzor	zyzywzor
pazsyf	papazsyf
sugy	susugy
laret	lalaret
fefeb	fefefeb
netezbub	nenetezbub
miqujycyviq	mimiqujycyviq
rogijkev	rorogijkev
kolet	kokolet
lybys	lylybys
jeqizeg	jejeqizeg
xib	xixib
gatexqognewta	gagatexqognewta
tibiknoryhfo	titibiknoryhfo
lehrof	lelehrof
rohhokexcux	rorohhokexcux
zatok	zazatok
dodry	dododry
vafzi	vavafzi
tyqydemod	tytyqydemod
hitno	hihitno
vebyl	vevebyl
vohqucur	vovohqucur
ryjno	ryryjno
bohqor	bobohqor
fovis	fofovis
pehugyc	pepehugyc
cec	cecec
xeljuqivi	xexeljuqivi
sovudyfbynos	sosovudyfbynos
tefwirrel	tetefwirrel
vus	vuvus
xegse	xexegse
rowem	rorowem
jigivivyswaz	jijigivivyswaz
byjaqku	bybyjaqku
letuzacuz	leletuzacuz
cojpa	cocojpa
zizycoqkit	zizizycoqkit
kati	kakati
dedgogtu	dededgogtu
hoqa	hohoqa
tyswybbatifyx	tytyswybbatifyx
losfa	lolosfa
cajurtasocux	cacajurtasocux
qukowvu	ququkowvu
zezvev	zezezvev
sobrek	sosobrek
tivpovomyhri	titivpovomyhri
sew	sesew
quxofab	ququxofab
xyr	xyxyr
coxsowxe	cocoxsowxe
gytpuma	gygytpuma
jahfex	jajahfex
byke	bybyke
bytru	bybytru
pyle	pypyle
rije	ririje
vetictawu	vevetictawu
xanciqu	xaxanciqu
cyfiduzquhi	cycyfiduzquhi
bedex	bebedex
masazokbegjob	mamasazokbegjob
lycnygxor	lylycnygxor
pizuqom	pipizuqom
rohqohic	rorohqohic
zurtixy	zuzurtixy
ryhe	ryryhe
bobym	bobobym
qimzojidy	qiqimzojidy
vica	vivica
riplak	ririplak
sahalsol	sasahalsol
cicyzgavi	cicicyzgavi
foxyn	fofoxyn
nesxoh	nenesxoh
lokagonwar	lolokagonwar
jyvucmifo	jyjyvucmifo
totym	tototym
hemygyt	hehemygyt
xuhorcersoxgef	xuxuhorcersoxgef
fywle	fyfywle
kewu	kekewu
witduv	wiwitduv
ruqqyz	ruruqqyz
simce	sisimce
kojomesyj	kokojomesyj
gyniflo	gygyniflo
zarje	zazarje
zahepzov	zazahepzov
wanrehge	wawanrehge
poxfytqiga	popoxfytqiga
lolif	lololif
wezxuxanowax	wewezxuxanowax
duze	duduze
wiwygvuxty	wiwiwygvuxty
befmefgi	bebefmefgi
luxowbu	luluxowbu
rejbihih	rerejbihih
lyzu	lylyzu
wokula	wowokula
kixtugody	kikixtugody
qyfepi	qyqyfepi
vozlevyfnyv	vovozlevyfnyv
himcysiga	hihimcysiga
janhinxelgoje	jajanhinxelgoje
xevux	xexevux
kelus	kekelus
dixy	didixy
lyrfis	lylyrfis
xetryxissajfi	xexetryxissajfi
pyjojyxyta	pypyjojyxyta
qegkot	qeqegkot
xurmijsahibsy	xuxurmijsahibsy
qugommy	ququgommy
jeqvofvuvvi	jejeqvofvuvvi
zuhucdejyf	zuzuhucdejyf
mutvemly	mumutvemly
puhvytys	pupuhvytys
bire	bibire
byvej	bybyvej
bedmyvikqilok	bebedmyvikqilok
zupo	zuzupo
qomrokafexdy	qoqomrokafexdy
hufy	huhufy
bovhuwloxlonaj	bobovhuwloxlonaj
syqaqqo	sysyqaqqo
hyzmijaj	hyhyzmijaj
qolo	qoqolo
wawevu	wawawevu
laqnoromdy	lalaqnoromdy
tivaxo	titivaxo
hym	hyhym
suhirorekbez	susuhirorekbez
fip	fifip
vixo	vivixo
qaget	qaqaget
hyhipjapgybkep	hyhyhipjapgybkep
gajybdytefsi	gagajybdytefsi
madin	mamadin
dygbyvfy	dydygbyvfy
xipamhun	xixipamhun
zofce	zozofce
potig	popotig
qijib	qiqijib
hoce	hohoce
coqxup	cocoqxup
riqzyrsy	ririqzyrsy
hucer	huhucer
hypgyx	hyhypgyx
nuhhe	nunuhhe
zoleducwojgen	zozoleducwojgen
meppyfi	memeppyfi
kucugpuc	kukucugpuc
fywijyhce	fyfywijyhce
qutsejog	ququtsejog
kapox	kakapox
legmumfywaqne	lelegmumfywaqne
pihynij	pipihynij
masxog	mamasxog
nypib	nynypib
qybod	qyqybod
hardor	hahardor
quvjez	ququvjez
fexfa	fefexfa
cenyry	cecenyry
kyqva	kykyqva