wedo	w-ewe-d-o
bigxij	b-ibi-g-x-i-j
kocmiveqeciw	k-oko-c-m-i-v-e-q-e-c-i-w
qumyw	q-uqu-m-y-w
sylys	s-ysy-l-y-s
zyqafij	z-yzy-q-a-f-i-j
zypwabi	z-yzy-p-w-a-b-i
taby	t-ata-b-y
jarnumjy	j-aja-r-n-u-m-j-y
livkuwpa	l-ili-v-k-u-w-p-a
jigiqfy	j-iji-g-i-q-f-y
vapav	v-ava-p-a-v
divu	d-idi-v-u
wyse	w-ywy-s-e
pit	p-ipi-t
selegifbubze	s-ese-l-e-g-i-f-b-u-b-z-e
cawfaj	c-aca-w-f-a-j
zakbowloh	z-aza-k-b-o-w-l-o-h
pyle	p-ypy-l-e
qylu	q-yqy-l-u
recgadxovsa	r-ere-c-g-a-d-x-o-v-s-a
lyxcesah	l-yly-x-c-e-s-a-h
fyhu	f-yfy-h-u
badibu	b-aba-d-i-b-u
pedji	p-epe-d-j-i
cexux	c-ece-x-u-x
bah	b-aba-h
ri	r-iri
bukotqug	b-ubu-k-o-t-q-u-g
takzim	t-ata-k-z-i-m
noqcaqpelaz	n-ono-q-c-a-q-p-e-l-a-z
vojine	v-ovo-j-i-n-e
wuba	w-uwu-b-a
fib	f-ifi-b
byku	b-yby-k-u
jane	j-aja-n-e
tedujti	t-ete-d-u-j-t-i
cecakfabdyg	c-ece-c-a-k-f-a-b-d-y-g
gihovkeljy	g-igi-h-o-v-k-e-l-j-y
varnap	v-ava-r-n-a-p
lihobaf	l-ili-h-o-b-a-f
tarhup	t-ata-r-h-u-p
dabehwij	d-ada-b-e-h-w-i-j
joccy	j-ojo-c-c-y
mesvinpyfo	m-eme-s-v-i-n-p-y-f-o
pidwi	p-ipi-d-w-i
nyrvucixlyfcy	n-yny-r-v-u-c-i-x-l-y-f-c-y
weqi	w-ewe-q-i
mexuf	m-eme-x-u-f
qevhe	q-eqe-v-h-e
gogip	g-ogo-g-i-p
wum	w-uwu-m
nave	n-ana-v-e
zarbex	z-aza-r-b-e-x
kopo	k-oko-p-o
vambap	v-ava-m-b-a-p
qokezos	q-oqo-k-e-z-o-s
dugom	d-udu-g-o-m
vetlirlitufy	v-eve-t-l-i-r-l-i-t-u-f-y
rek	r-ere-k
ranbok	r-ara-n-b-o-k
ges	g-ege-s
nerfu	n-ene-r-f-u
luq	l-ulu-q
bewma	b-ebe-w-m-a
xodcy	x-oxo-d-c-y
duqluquwbige	d-udu-q-l-u-q-u-w-b-i-g-e
hyjeca	h-yhy-j-e-c-a
githoqtat	g-igi-t-h-o-q-t-a-t
kergaqymhi	k-eke-r-g-a-q-y-m-h-i
toto	t-oto-t-o
ter	t-ete-r
jak	j-aja-k
xixpyc	x-ixi-x-p-y-c
hakhylan	h-aha-k-h-y-l-a-n
ref	r-ere-f
kiw	k-iki-w
wajse	w-awa-j-s-e
jexgykhufpu	j-eje-x-g-y-k-h-u-f-p-u
niqex	n-ini-q-e-x
sab	s-asa-b
xaruspabe	x-axa-r-u-s-p-a-b-e
to	t-oto
nup	n-unu-p
nomy	n-ono-m-y
feljela	f-efe-l-j-e-l-a
xetryxissajfi	x-exe-t-r-y-x-i-s-s-a-j-f-i
mig	m-imi-g
faf	f-afa-f
qisalzuhxynpaw	q-iqi-s-a-l-z-u-h-x-y-n-p-a-w
nejyt	n-ene-j-y-t
bajji	b-aba-j-j-i
jyvsasof	j-yjy-v-s-a-s-o-f
lycfur	l-yly-c-f-u-r
kafylxexigsyr	k-aka-f-y-l-x-e-x-i-g-s-y-r
haghi	h-aha-g-h-i
nibo	n-ini-b-o
muldokipiqryj	m-umu-l-d-o-k-i-p-i-q-r-y-j
cuqogmukges	c-ucu-q-o-g-m-u-k-g-e-s
jacta	j-aja-c-t-a
tejkonigo	t-ete-j-k-o-n-i-g-o
qedped	q-eqe-d-p-e-d
dyfudmu	d-ydy-f-u-d-m-u
faldifav	f-afa-l-d-i-f-a-v
parsyq	p-apa-r-s-y-q
syhhozmeke	s-ysy-h-h-o-z-m-e-k-e
gevcy	g-ege-v-c-y
dabzehbyk	d-ada-b-z-e-h-b-y-k
fihal	f-ifi-h-a-l
sefy	s-ese-f-y
cewyhivpadoh	c-ece-w-y-h-i-v-p-a-d-o-h
xurkijno	x-uxu-r-k-i-j-n-o
dugmo	d-udu-g-m-o
dub	d-udu-b
qyqta	q-yqy-q-t-a
fazaxsun	f-afa-z-a-x-s-u-n
xegxac	x-exe-g-x-a-c
nyz	n-yny-z
jagxo	j-aja-g-x-o
vijka	v-ivi-j-k-a
melryjohtubun	m-eme-l-r-y-j-o-h-t-u-b-u-n
tefhe	t-ete-f-h-e
xaboq	x-axa-b-o-q
giddaw	g-igi-d-d-a-w
vumek	v-uvu-m-e-k
risko	r-iri-s-k-o
zyq	z-yzy-q
kobe	k-oko-b-e
dawxan	d-ada-w-x-a-n
muf	m-umu-f
myc	m-ymy-c
cavabdiv	c-aca-v-a-b-d-i-v
retmig	r-ere-t-m-i-g
zepwefak	z-eze-p-w-e-f-a-k
vab	v-ava-b
dyxogixzo	d-ydy-x-o-g-i-x-z-o
giqwiqkannywjaf	g-igi-q-w-i-q-k-a-n-n-y-w-j-a-f
zuniratna	z-uzu-n-i-r-a-t-n-a
nucxuran	n-unu-c-x-u-r-a-n
xuwtohoc	x-uxu-w-t-o-h-o-c
lysor	l-yly-s-o-r
zikjydfel	z-izi-k-j-y-d-f-e-l
zorfyzic	z-ozo-r-f-y-z-i-c
tadecgecoktuk	t-ata-d-e-c-g-e-c-o-k-t-u-k
sahifbeh	s-asa-h-i-f-b-e-h
larwu	l-ala-r-w-u
nyjy	n-yny-j-y
lafyjar	l-ala-f-y-j-a-r
cihjo	c-ici-h-j-o
xemsix	x-exe-m-s-i-x
sifum	s-isi-f-u-m
nozdoznaviv	n-ono-z-d-o-z-n-a-v-i-v
tykkydy	t-yty-k-k-y-d-y
xeja	x-exe-j-a
vewuxo	v-eve-w-u-x-o
buhi	b-ubu-h-i
xiwekxoj	x-ixi-w-e-k-x-o-j
cib	c-ici-b
jacypqihetben	j-aja-c-y-p-q-i-h-e-t-b-e-n
liglezo	l-ili-g-l-e-z-o
nok	n-ono-k
gikikotiha	g-igi-k-i-k-o-t-i-h-a
wupol	w-uwu-p-o-l
myqlorehovnu	m-ymy-q-l-o-r-e-h-o-v-n-u
dek	d-ede-k
tinadetydhog	t-iti-n-a-d-e-t-y-d-h-o-g
qinydve	q-iqi-n-y-d-v-e
famu	f-afa-m-u
huvdefyciz	h-uhu-v-d-e-f-y-c-i-z
boqha	b-obo-q-h-a
weldotyx	w-ewe-l-d-o-t-y-x
reqo	r-ere-q-o
cih	c-ici-h
xixxixambu	x-ixi-x-x-i-x-a-m-b-u
nyb	n-yny-b
cogude	c-oco-g-u-d-e
fisrus	f-ifi-s-r-u-s
rusdop	r-uru-s-d-o-p
totogegydre	t-oto-t-o-g-e-g-y-d-r-e
wupve	w-uwu-p-v-e
pujcubazhom	p-upu-j-c-u-b-a-z-h-o-m
lipgabaxu	l-ili-p-g-a-b-a-x-u
lehnilutup	l-ele-h-n-i-l-u-t-u-p
cac	c-aca-c
waloq	w-awa-l-o-q
hexuwamseru	h-ehe-x-u-w-a-m-s-e-r-u
rofpe	r-oro-f-p-e
zec	z-eze-c
vupemnozgig	v-uvu-p-e-m-n-o-z-g-i-g
cury	c-ucu-r-y
xepuz	x-exe-p-u-z
reza	r-ere-z-a
tawtaq	t-ata-w-t-a-q
duwis	d-udu-w-i-s
tazeh	t-ata-z-e-h
zezza	z-eze-z-z-a
zadeb	z-aza-d-e-b
tizohzo	t-iti-z-o-h-z-o
jeflarji	j-eje-f-l-a-r-j-i
vowxapvogkamwot	v-ovo-w-x-a-p-v-o-g-k-a-m-w-o-t
sidzaj	s-isi-d-z-a-j
loreletke	l-olo-r-e-l-e-t-k-e
lenag	l-ele-n-a-g
vobyq	v-ovo-b-y-q
tirup	t-iti-r-u-p
sujpaneforyq	s-usu-j-p-a-n-e-f-o-r-y-q
vofqet	v-ovo-f-q-e-t
cevu	c-ece-v-u
tyqu	t-yty-q-u
nyjywqixveson	n-yny-j-y-w-q-i-x-v-e-s-o-n
le	l-ele
gufav	g-ugu-f-a-v
cenyry	c-ece-n-y-r-y
wicvol	w-iwi-c-v-o-l
mabet	m-ama-b-e-t
muqy	m-umu-q-y
vavluvyphynup	v-ava-v-l-u-v-y-p-h-y-n-u-p
worqij	w-owo-r-q-i-j
harvug	h-aha-r-v-u-g
guble	g-ugu-b-l-e
liti	l-ili-t-i
nokhyg	n-ono-k-h-y-g
zas	z-aza-s
zolurqu	z-ozo-l-u-r-q-u
lyheh	l-yly-h-e-h
fozod	f-ofo-z-o-d
caw	c-aca-w
gixxe	g-igi-x-x-e
gyfhem	g-ygy-f-h-e-m
myrcaffazak	m-ymy-r-c-a-f-f-a-z-a-k
kikhe	k-iki-k-h-e
hywig	h-yhy-w-i-g
kaxag	k-aka-x-a-g
fagivo	f-afa-g-i-v-o
zykytwymi	z-yzy-k-y-t-w-y-m-i
mucanwo	m-umu-c-a-n-w-o
sagmomiz	s-asa-g-m-o-m-i-z
soroqi	s-oso-r-o-q-i
wezxukrab	w-ewe-z-x-u-k-r-a-b
puzejbaz	p-upu-z-e-j-b-a-z
suntifsetahpif	s-usu-n-t-i-f-s-e-t-a-h-p-i-f
wojnozyj	w-owo-j-n-o-z-y-j
wesxowrujhuvfes	w-ewe-s-x-o-w-r-u-j-h-u-v-f-e-s
pyqco	p-ypy-q-c-o
nudbis	n-unu-d-b-i-s
pyrujumonu	p-ypy-r-u-j-u-m-o-n-u
rade	r-ara-d-e
teqlo	t-ete-q-l-o
ryfcyz	r-yry-f-c-y-z
lefzys	l-ele-f-z-y-s
qybib	q-yqy-b-i-b
bewinceftujxur	b-ebe-w-i-n-c-e-f-t-u-j-x-u-r
qomwom	q-oqo-m-w-o-m
zotazxaqiziw	z-ozo-t-a-z-x-a-q-i-z-i-w
kiracabdo	k-iki-r-a-c-a-b-d-o
naqwif	n-ana-q-w-i-f
qiwad	q-iqi-w-a-d
wiqve	w-iwi-q-v-e
qetpu	q-eqe-t-p-u
pixoqeseshaj	p-ipi-x-o-q-e-s-e-s-h-a-j
pecel	p-epe-c-e-l
qaba	q-aqa-b-a
wimxe	w-iwi-m-x-e
xyxse	x-yxy-x-s-e
tozto	t-oto-z-t-o
quk	q-uqu-k
qob	q-oqo-b
xan	x-axa-n
sifis	s-isi-f-i-s
paq	p-apa-q
bodi	b-obo-d-i
timylyr	t-iti-m-y-l-y-r
veqipqy	v-eve-q-i-p-q-y
sonul	s-oso-n-u-l
kyluxi	k-yky-l-u-x-i
cakorjobapac	c-aca-k-o-r-j-o-b-a-p-a-c
ka	k-aka
bycorpatyd	b-yby-c-o-r-p-a-t-y-d
qomrokafexdy	q-oqo-m-r-o-k-a-f-e-x-d-y
hetyrky	h-ehe-t-y-r-k-y
vudfubyt	v-uvu-d-f-u-b-y-t
qifjocji	q-iqi-f-j-o-c-j-i
sufufe	s-usu-f-u-f-e
hel	h-ehe-l
kiwfo	k-iki-w-f-o
kuvi	k-uku-v-i
zawekurgyl	z-aza-w-e-k-u-r-g-y-l
tegjespa	t-ete-g-j-e-s-p-a
rowypdempohi	r-oro-w-y-p-d-e-m-p-o-h-i
qywibugkur	q-yqy-w-i-b-u-g-k-u-r
xyzet	x-yxy-z-e-t
vobzy	v-ovo-b-z-y
typvur	t-yty-p-v-u-r
jyvmu	j-yjy-v-m-u
dokjabex	d-odo-k-j-a-b-e-x
paro	p-apa-r-o
manon	m-ama-n-o-n
wuf	w-uwu-f
dezkag	d-ede-z-k-a-g
dely	d-ede-l-y
zyjimlixcuf	z-yzy-j-i-m-l-i-x-c-u-f
rarseh	r-ara-r-s-e-h
zunaf	z-uzu-n-a-f
nudru	n-unu-d-r-u
vufurli	v-uvu-f-u-r-l-i
suhbaq	s-usu-h-b-a-q
mehuleco	m-eme-h-u-l-e-c-o
qadsi	q-aqa-d-s-i
hypusfys	h-yhy-p-u-s-f-y-s
ceko	c-ece-k-o
veqotza	v-eve-q-o-t-z-a
kob	k-oko-b
pakvun	p-apa-k-v-u-n
kilap	k-iki-l-a-p
nydoqifgyc	n-yny-d-o-q-i-f-g-y-c
xicos	x-ixi-c-o-s
bepa	b-ebe-p-a
hygawpupiqla	h-yhy-g-a-w-p-u-p-i-q-l-a
darcar	d-ada-r-c-a-r
boxqymos	b-obo-x-q-y-m-o-s
tuvanac	t-utu-v-a-n-a-c
javiwyqyknu	j-aja-v-i-w-y-q-y-k-n-u
ruxnyz	r-uru-x-n-y-z
feram	f-efe-r-a-m
durlu	d-udu-r-l-u
wiker	w-iwi-k-e-r
gujykxem	g-ugu-j-y-k-x-e-m
lywwiqwomijka	l-yly-w-w-i-q-w-o-m-i-j-k-a
tazsa	t-ata-z-s-a
hiko	h-ihi-k-o
zebi	z-eze-b-i
wuvraz	w-uwu-v-r-a-z
jodetu	j-ojo-d-e-t-u
tukjuvtisgoxe	t-utu-k-j-u-v-t-i-s-g-o-x-e
bewqew	b-ebe-w-q-e-w
cyzdu	c-ycy-z-d-u
jewwusopcah	j-eje-w-w-u-s-o-p-c-a-h
lytpuhdomi	l-yly-t-p-u-h-d-o-m-i
wofaw	w-owo-f-a-w
lyhson	l-yly-h-s-o-n
gali	g-aga-l-i
gyw	g-ygy-w
ragbufu	r-ara-g-b-u-f-u
foxki	f-ofo-x-k-i
pohponykkuw	p-opo-h-p-o-n-y-k-k-u-w
wombisjof	w-owo-m-b-i-s-j-o-f
xyssudur	x-yxy-s-s-u-d-u-r
gyqijcyp	g-ygy-q-i-j-c-y-p
rowakojkyb	r-oro-w-a-k-o-j-k-y-b
rydvudqifixdoh	r-yry-d-v-u-d-q-i-f-i-x-d-o-h
lor	l-olo-r
dispygarac	d-idi-s-p-y-g-a-r-a-c
remux	r-ere-m-u-x
diro	d-idi-r-o
tawi	t-ata-w-i
sozena	s-oso-z-e-n-a
kyfow	k-yky-f-o-w
saq	s-asa-q
cidqud	c-ici-d-q-u-d
fifho	f-ifi-f-h-o
tuktod	t-utu-k-t-o-d
domxyg	d-odo-m-x-y-g
qehuj	q-eqe-h-u-j
votyl	v-ovo-t-y-l
bebuf	b-ebe-b-u-f
guwpyrnuwe	g-ugu-w-p-y-r-n-u-w-e
wytigqidcytky	w-ywy-t-i-g-q-i-d-c-y-t-k-y
zaldo	z-aza-l-d-o
fun	f-ufu-n
pynropi	p-ypy-n-r-o-p-i
maxro	m-ama-x-r-o
dajacy	d-ada-j-a-c-y
komujfi	k-oko-m-u-j-f-i
fawfa	f-afa-w-f-a
tibuzatbo	t-iti-b-u-z-a-t-b-o
kewu	k-eke-w-u
todoridavnez	t-oto-d-o-r-i-d-a-v-n-e-z
joxkud	j-ojo-x-k-u-d
hysci	h-yhy-s-c-i
lihbujdib	l-ili-h-b-u-j-d-i-b
towob	t-oto-w-o-b
kiq	k-iki-q
kojemqi	k-oko-j-e-m-q-i
qecysy	q-eqe-c-y-s-y
nanoxwequziz	n-ana-n-o-x-w-e-q-u-z-i-z
dyrib	d-ydy-r-i-b
bocfa	b-obo-c-f-a
zugordog	z-uzu-g-o-r-d-o-g
cab	c-aca-b
mukzisy	m-umu-k-z-i-s-y
buted	b-ubu-t-e-d
tad	t-ata-d
tanza	t-ata-n-z-a
coxsowxe	c-oco-x-s-o-w-x-e
welse	w-ewe-l-s-e
qyfipemudzyn	q-yqy-f-i-p-e-m-u-d-z-y-n
ryvgegoz	r-yry-v-g-e-g-o-z
tadnon	t-ata-d-n-o-n
calhedmeramu	c-aca-l-h-e-d-m-e-r-a-m-u
zofof	z-ozo-f-o-f
jetutliplemet	j-eje-t-u-t-l-i-p-l-e-m-e-t
fuwdera	f-ufu-w-d-e-r-a
gascab	g-aga-s-c-a-b
wulsyxponitxu	w-uwu-l-s-y-x-p-o-n-i-t-x-u
ruggi	r-uru-g-g-i
qyty	q-yqy-t-y
qaxni	q-aqa-x-n-i
togso	t-oto-g-s-o
wawevu	w-awa-w-e-v-u
timirdikcimij	t-iti-m-i-r-d-i-k-c-i-m-i-j
dihwyci	d-idi-h-w-y-c-i
radvyg	r-ara-d-v-y-g
cudi	c-ucu-d-i
luxtude	l-ulu-x-t-u-d-e
zofca	z-ozo-f-c-a
zyxnadpoj	z-yzy-x-n-a-d-p-o-j
jupcyzmiwpef	j-uju-p-c-y-z-m-i-w-p-e-f
lyvedurkeg	l-yly-v-e-d-u-r-k-e-g
madin	m-ama-d-i-n
vyhisfac	v-yvy-h-i-s-f-a-c
ciqor	c-ici-q-o-r
pajfiljonmob	p-apa-j-f-i-l-j-o-n-m-o-b
tuti	t-utu-t-i
vohwy	v-ovo-h-w-y
qy	q-yqy
tojget	t-oto-j-g-e-t
higo	h-ihi-g-o
livy	l-ili-v-y
jyr	j-yjy-r
nabu	n-ana-b-u
posohel	p-opo-s-o-h-e-l
pimet	p-ipi-m-e-t
viqzevna	v-ivi-q-z-e-v-n-a
pugus	p-upu-g-u-s
kuvfup	k-uku-v-f-u-p
lyjfevecym	l-yly-j-f-e-v-e-c-y-m
wujcyfkyn	w-uwu-j-c-y-f-k-y-n
mockicsis	m-omo-c-k-i-c-s-i-s
jygju	j-yjy-g-j-u
lihisgeh	l-ili-h-i-s-g-e-h
kefgal	k-eke-f-g-a-l
jucy	j-uju-c-y
wopyw	w-owo-p-y-w
cojrokeznytxik	c-oco-j-r-o-k-e-z-n-y-t-x-i-k
qihwe	q-iqi-h-w-e
nyllys	n-yny-l-l-y-s
rysalre	r-yry-s-a-l-r-e
zymy	z-yzy-m-y
qim	q-iqi-m
mogsal	m-omo-g-s-a-l
wyfudlyl	w-ywy-f-u-d-l-y-l
ze	z-eze
dypmelovy	d-ydy-p-m-e-l-o-v-y
muhcypihqik	m-umu-h-c-y-p-i-h-q-i-k
sanaqginlanek	s-asa-n-a-q-g-i-n-l-a-n-e-k
qyxveqoxxo	q-yqy-x-v-e-q-o-x-x-o
xohvogcuk	x-oxo-h-v-o-g-c-u-k
gekkomar	g-ege-k-k-o-m-a-r
canqoj	c-aca-n-q-o-j
vodhegpisha	v-ovo-d-h-e-g-p-i-s-h-a
sujpehos	s-usu-j-p-e-h-o-s
puzy	p-upu-z-y
poxab	p-opo-x-a-b
lilivgofhexuc	l-ili-l-i-v-g-o-f-h-e-x-u-c
tishedqiw	t-iti-s-h-e-d-q-i-w
xegxy	x-exe-g-x-y
nocly	n-ono-c-l-y
janor	j-aja-n-o-r
sogiqdexadzyf	s-oso-g-i-q-d-e-x-a-d-z-y-f
bitxunbiwfy	b-ibi-t-x-u-n-b-i-w-f-y
foxyn	f-ofo-x-y-n
xipbe	x-ixi-p-b-e
neqnewyzepgym	n-ene-q-n-e-w-y-z-e-p-g-y-m
fyvaxuhiv	f-yfy-v-a-x-u-h-i-v
mym	m-ymy-m
menxuc	m-eme-n-x-u-c
gemladbanig	g-ege-m-l-a-d-b-a-n-i-g
nenmuho	n-ene-n-m-u-h-o
diryhlic	d-idi-r-y-h-l-i-c
siftac	s-isi-f-t-a-c
ledynge	l-ele-d-y-n-g-e
xowim	x-oxo-w-i-m
kijde	k-iki-j-d-e
vamituz	v-ava-m-i-t-u-z
jixe	j-iji-x-e
map	m-ama-p
vigxupmi	v-ivi-g-x-u-p-m-i
xuxfem	x-uxu-x-f-e-m
vohra	v-ovo-h-r-a
dumny	d-udu-m-n-y
cobxedcatdut	c-oco-b-x-e-d-c-a-t-d-u-t
bogza	b-obo-g-z-a
xurwyfowfenpah	x-uxu-r-w-y-f-o-w-f-e-n-p-a-h
byru	b-yby-r-u
faqo	f-afa-q-o
nytu	n-yny-t-u
baw	b-aba-w
sescopnypbe	s-ese-s-c-o-p-n-y-p-b-e
pumxyqwek	p-upu-m-x-y-q-w-e-k
dekqol	d-ede-k-q-o-l
vevby	v-eve-v-b-y
boroq	b-obo-r-o-q
sivru	s-isi-v-r-u
zanuwgit	z-aza-n-u-w-g-i-t
mocedohsu	m-omo-c-e-d-o-h-s-u
lyxwazhuge	l-yly-x-w-a-z-h-u-g-e
putegusoxyz	p-upu-t-e-g-u-s-o-x-y-z
ratge	r-ara-t-g-e
qugba	q-uqu-g-b-a
denpagzyd	d-ede-n-p-a-g-z-y-d
kyjwumakiqen	k-yky-j-w-u-m-a-k-i-q-e-n
mulyp	m-umu-l-y-p
lulys	l-ulu-l-y-s
tigac	t-iti-g-a-c
gagepgefaqke	g-aga-g-e-p-g-e-f-a-q-k-e
vuwowmol	v-uvu-w-o-w-m-o-l
xutduvup	x-uxu-t-d-u-v-u-p
kucjutuboc	k-uku-c-j-u-t-u-b-o-c
lesikavilsoz	l-ele-s-i-k-a-v-i-l-s-o-z
xohco	x-oxo-h-c-o
sumerev	s-usu-m-e-r-e-v
wyhzofi	w-ywy-h-z-o-f-i
wuqhyqoc	w-uwu-q-h-y-q-o-c
zejixawnab	z-eze-j-i-x-a-w-n-a-b
madic	m-ama-d-i-c
xirky	x-ixi-r-k-y
xuxysu	x-uxu-x-y-s-u
poqa	p-opo-q-a
joceryw	j-ojo-c-e-r-y-w
gukaj	g-ugu-k-a-j
nejwenem	n-ene-j-w-e-n-e-m
vodvapto	v-ovo-d-v-a-p-t-o
vupup	v-uvu-p-u-p
rep	r-ere-p
nu	n-unu
myqaxmopi	m-ymy-q-a-x-m-o-p-i
fihkefma	f-ifi-h-k-e-f-m-a
byhyw	b-yby-h-y-w
bumi	b-ubu-m-i
gomse	g-ogo-m-s-e
risviw	r-iri-s-v-i-w
qycotfon	q-yqy-c-o-t-f-o-n
gel	g-ege-l
jexifyrkejvi	j-eje-x-i-f-y-r-k-e-j-v-i
semtunmiglem	s-ese-m-t-u-n-m-i-g-l-e-m
pemxoz	p-epe-m-x-o-z
letdexizeqla	l-ele-t-d-e-x-i-z-e-q-l-a
solhalfi	s-oso-l-h-a-l-f-i
zyfveb	z-yzy-f-v-e-b
zuzhu	z-uzu-z-h-u
bagcalsuv	b-aba-g-c-a-l-s-u-v
zim	z-izi-m
muciv	m-umu-c-i-v
kitnywo	k-iki-t-n-y-w-o
balpa	b-aba-l-p-a
xyrxuzusvu	x-yxy-r-x-u-z-u-s-v-u
fohusalxo	f-ofo-h-u-s-a-l-x-o
xepkafbom	x-exe-p-k-a-f-b-o-m
fexnefazo	f-efe-x-n-e-f-a-z-o
mil	m-imi-l
fekhom	f-efe-k-h-o-m
how	h-oho-w
fyma	f-yfy-m-a
mawci	m-ama-w-c-i
faxpiscigvat	f-afa-x-p-i-s-c-i-g-v-a-t
zullod	z-uzu-l-l-o-d
zesuju	z-eze-s-u-j-u
sazfy	s-asa-z-f-y
xyjy	x-yxy-j-y
mucgud	m-umu-c-g-u-d
xeto	x-exe-t-o
vinaw	v-ivi-n-a-w
puny	p-upu-n-y
zuvxutoqox	z-uzu-v-x-u-t-o-q-o-x
doctac	d-odo-c-t-a-c
tidco	t-iti-d-c-o
lokagonwar	l-olo-k-a-g-o-n-w-a-r
vazy	v-ava-z-y
borofa	b-obo-r-o-f-a
voguz	v-ovo-g-u-z
falekdygxy	f-afa-l-e-k-d-y-g-x-y
quhcimpy	q-uqu-h-c-i-m-p-y
jybasugsebvy	j-yjy-b-a-s-u-g-s-e-b-v-y
mipsucyt	m-imi-p-s-u-c-y-t
haqat	h-aha-q-a-t
cybputimvydwy	c-ycy-b-p-u-t-i-m-v-y-d-w-y
lapujolec	l-ala-p-u-j-o-l-e-c
qohogrij	q-oqo-h-o-g-r-i-j
ryvkibzyx	r-yry-v-k-i-b-z-y-x
tobtiraselu	t-oto-b-t-i-r-a-s-e-l-u
pobxuxo	p-opo-b-x-u-x-o
rykore	r-yry-k-o-r-e
xosvyskotypok	x-oxo-s-v-y-s-k-o-t-y-p-o-k
rewmyla	r-ere-w-m-y-l-a
xizhyk	x-ixi-z-h-y-k
zaqupmabyz	z-aza-q-u-p-m-a-b-y-z
ced	c-ece-d
fogvag	f-ofo-g-v-a-g
coqgup	c-oco-q-g-u-p
pila	p-ipi-l-a
mozbug	m-omo-z-b-u-g
vaxtax	v-ava-x-t-a-x
jidsil	j-iji-d-s-i-l
putsa	p-upu-t-s-a
sojebel	s-oso-j-e-b-e-l
cemalvu	c-ece-m-a-l-v-u
zeccilxopnuny	z-eze-c-c-i-l-x-o-p-n-u-n-y
sesaqxel	s-ese-s-a-q-x-e-l
tevnylteja	t-ete-v-n-y-l-t-e-j-a
cerryti	c-ece-r-r-y-t-i
bidi	b-ibi-d-i
tanaxakfax	t-ata-n-a-x-a-k-f-a-x
hodqonenhoje	h-oho-d-q-o-n-e-n-h-o-j-e
logfur	l-olo-g-f-u-r
lewi	l-ele-w-i
cas	c-aca-s
myvywdaqo	m-ymy-v-y-w-d-a-q-o
hosfodnuf	h-oho-s-f-o-d-n-u-f
depa	d-ede-p-a
buxyfno	b-ubu-x-y-f-n-o
buhqofub	b-ubu-h-q-o-f-u-b
nesigxer	n-ene-s-i-g-x-e-r
kuttinlos	k-uku-t-t-i-n-l-o-s
rifu	r-iri-f-u
jofvotho	j-ojo-f-v-o-t-h-o
rabcugja	r-ara-b-c-u-g-j-a
giw	g-igi-w
reqe	r-ere-q-e
polno	p-opo-l-n-o
pafedu	p-apa-f-e-d-u
duze	d-udu-z-e
caralapitni	c-aca-r-a-l-a-p-i-t-n-i
rybgaqedosboj	r-yry-b-g-a-q-e-d-o-s-b-o-j
gapi	g-aga-p-i
gonole	g-ogo-n-o-l-e
qedufije	q-eqe-d-u-f-i-j-e
jagzobutnospyp	j-aja-g-z-o-b-u-t-n-o-s-p-y-p
kalah	k-aka-l-a-h
xege	x-exe-g-e
fiwa	f-ifi-w-a
pelrublifo	p-epe-l-r-u-b-l-i-f-o
comij	c-oco-m-i-j
hucer	h-uhu-c-e-r
zatu	z-aza-t-u
ron	r-oro-n
pewnys	p-epe-w-n-y-s
tyzkew	t-yty-z-k-e-w
goxpitcurewmis	g-ogo-x-p-i-t-c-u-r-e-w-m-i-s
mefo	m-eme-f-o
bezonuq	b-ebe-z-o-n-u-q
tabnel	t-ata-b-n-e-l
kucqafno	k-uku-c-q-a-f-n-o
boghysocobgyk	b-obo-g-h-y-s-o-c-o-b-g-y-k
pepvu	p-epe-p-v-u
niqujkaqzym	n-ini-q-u-j-k-a-q-z-y-m
muqjesqyfom	m-umu-q-j-e-s-q-y-f-o-m
ratul	r-ara-t-u-l
runren	r-uru-n-r-e-n
wekpepwul	w-ewe-k-p-e-p-w-u-l
qoczi	q-oqo-c-z-i
tiwikanumbuw	t-iti-w-i-k-a-n-u-m-b-u-w
zivitboveg	z-izi-v-i-t-b-o-v-e-g
mysap	m-ymy-s-a-p
qyxcetysuv	q-yqy-x-c-e-t-y-s-u-v
tuhwuh	t-utu-h-w-u-h
nopigotu	n-ono-p-i-g-o-t-u
sithavmy	s-isi-t-h-a-v-m-y
modse	m-omo-d-s-e
fip	f-ifi-p
bobe	b-obo-b-e
mejufy	m-eme-j-u-f-y
hitpoz	h-ihi-t-p-o-z
roqqojfoxhy	r-oro-q-q-o-j-f-o-x-h-y
huxkuvif	h-uhu-x-k-u-v-i-f
cigi	c-ici-g-i
sopiqzyw	s-oso-p-i-q-z-y-w
zafakutafgi	z-aza-f-a-k-u-t-a-f-g-i
faqa	f-afa-q-a
byskiw	b-yby-s-k-i-w
sonos	s-oso-n-o-s
kizzohgid	k-iki-z-z-o-h-g-i-d
nyxse	n-yny-x-s-e
vonxojvil	v-ovo-n-x-o-j-v-i-l
wek	w-ewe-k
giq	g-igi-q
nygeqleba	n-yny-g-e-q-l-e-b-a
gaffa	g-aga-f-f-a
tarqefaf	t-ata-r-q-e-f-a-f
rugi	r-uru-g-i
depsu	d-ede-p-s-u
woke	w-owo-k-e
wezy	w-ewe-z-y
sunkyjkog	s-usu-n-k-y-j-k-o-g
baj	b-aba-j
fyqulwih	f-yfy-q-u-l-w-i-h
nervo	n-ene-r-v-o
jofem	j-ojo-f-e-m
fasfe	f-afa-s-f-e
vuz	v-uvu-z
taze	t-ata-z-e
qam	q-aqa-m
felo	f-efe-l-o
jovbet	j-ojo-v-b-e-t
lujec	l-ulu-j-e-c
nywvyfyk	n-yny-w-v-y-f-y-k
dury	d-udu-r-y
jigutsi	j-iji-g-u-t-s-i
lejvojqizusgo	l-ele-j-v-o-j-q-i-z-u-s-g-o
fysol	f-yfy-s-o-l
xip	x-ixi-p
rydrotgat	r-yry-d-r-o-t-g-a-t
keqlugyg	k-eke-q-l-u-g-y-g
reru	r-ere-r-u
baz	b-aba-z
calka	c-aca-l-k-a
merubsuv	m-eme-r-u-b-s-u-v
vefu	v-eve-f-u
zity	z-izi-t-y
mizzem	m-imi-z-z-e-m
cupej	c-ucu-p-e-j
faw	f-afa-w
dapip	d-ada-p-i-p
guge	g-ugu-g-e
cadysiv	c-aca-d-y-s-i-v
robewe	r-oro-b-e-w-e
wiguskah	w-iwi-g-u-s-k-a-h
qunufter	q-uqu-n-u-f-t-e-r
tirerkimugma	t-iti-r-e-r-k-i-m-u-g-m-a
typ	t-yty-p
bagah	b-aba-g-a-h
didbyceropy	d-idi-d-b-y-c-e-r-o-p-y
nikyko	n-ini-k-y-k-o
xihby	x-ixi-h-b-y
lyzakaf	l-yly-z-a-k-a-f
cuge	c-ucu-g-e
vykcamafwagnoc	v-yvy-k-c-a-m-a-f-w-a-g-n-o-c
rixomfem	r-iri-x-o-m-f-e-m
togarar	t-oto-g-a-r-a-r
cyvuq	c-ycy-v-u-q
kybcyhvunevkap	k-yky-b-c-y-h-v-u-n-e-v-k-a-p
nyqpuqxepvumtu	n-yny-q-p-u-q-x-e-p-v-u-m-t-u
poqjyf	p-opo-q-j-y-f
xixsez	x-ixi-x-s-e-z
kynvijy	k-yky-n-v-i-j-y
bymyr	b-yby-m-y-r
tonur	t-oto-n-u-r
rebgohsizylse	r-ere-b-g-o-h-s-i-z-y-l-s-e
jybut	j-yjy-b-u-t
bogfyva	b-obo-g-f-y-v-a
xonep	x-oxo-n-e-p
dehrolux	d-ede-h-r-o-l-u-x
qiliw	q-iqi-l-i-w
tadfu	t-ata-d-f-u
mukelifxa	m-umu-k-e-l-i-f-x-a
jomoq	j-ojo-m-o-q
modbyh	m-omo-d-b-y-h
loh	l-olo-h
nerij	n-ene-r-i-j
fuwa	f-ufu-w-a
zysdawixdunpov	z-yzy-s-d-a-w-i-x-d-u-n-p-o-v
daqfagry	d-ada-q-f-a-g-r-y
waslad	w-awa-s-l-a-d
rubqo	r-uru-b-q-o
vacsitfutsac	v-ava-c-s-i-t-f-u-t-s-a-c
ponapbod	p-opo-n-a-p-b-o-d
pame	p-apa-m-e
viw	v-ivi-w
lorju	l-olo-r-j-u
hihyg	h-ihi-h-y-g
jepkado	j-eje-p-k-a-d-o
vuwtapsif	v-uvu-w-t-a-p-s-i-f
lexymacagpuz	l-ele-x-y-m-a-c-a-g-p-u-z
sokuvyr	s-oso-k-u-v-y-r
tasatqoqsi	t-ata-s-a-t-q-o-q-s-i
mohupeg	m-omo-h-u-p-e-g
gomgymogtykroh	g-ogo-m-g-y-m-o-g-t-y-k-r-o-h
giwi	g-igi-w-i
pum	p-upu-m
faviq	f-afa-v-i-q
nabce	n-ana-b-c-e
mohzubipuza	m-omo-h-z-u-b-i-p-u-z-a
dicdytrigzize	d-idi-c-d-y-t-r-i-g-z-i-z-e
qiqykfasciqby	q-iqi-q-y-k-f-a-s-c-i-q-b-y
fowovy	f-ofo-w-o-v-y
vukku	v-uvu-k-k-u
gaquq	g-aga-q-u-q
mapypur	m-ama-p-y-p-u-r
gyczydumiqcy	g-ygy-c-z-y-d-u-m-i-q-c-y
tyr	t-yty-r
fymy	f-yfy-m-y
balfa	b-aba-l-f-a
gen	g-ege-n
lebonehdalvu	l-ele-b-o-n-e-h-d-a-l-v-u
kijzaqybo	k-iki-j-z-a-q-y-b-o
dununwe	d-udu-n-u-n-w-e
cezpohi	c-ece-z-p-o-h-i
fusez	f-ufu-s-e-z
vegwijjuqkypsa	v-eve-g-w-i-j-j-u-q-k-y-p-s-a
sojqex	s-oso-j-q-e-x
diguwgoj	d-idi-g-u-w-g-o-j
kykhetza	k-yky-k-h-e-t-z-a
zamcid	z-aza-m-c-i-d
nurhatju	n-unu-r-h-a-t-j-u
laz	l-ala-z
feb	f-efe-b
fervyj	f-efe-r-v-y-j
cidpik	c-ici-d-p-i-k
mugkejineguj	m-umu-g-k-e-j-i-n-e-g-u-j
kovy	k-oko-v-y
wybu	w-ywy-b-u
zugibzek	z-uzu-g-i-b-z-e-k
nynyd	n-yny-n-y-d
cosykyrax	c-oco-s-y-k-y-r-a-x
qozad	q-oqo-z-a-d
zefwe	z-eze-f-w-e
xybyb	x-yxy-b-y-b
hymuf	h-yhy-m-u-f
lenoxobnixre	l-ele-n-o-x-o-b-n-i-x-r-e
zoh	z-ozo-h
qobyrekud	q-oqo-b-y-r-e-k-u-d
xubinmelobny	x-uxu-b-i-n-m-e-l-o-b-n-y
zelnyxvimibva	z-eze-l-n-y-x-v-i-m-i-b-v-a
pilxat	p-ipi-l-x-a-t
jabig	j-aja-b-i-g
zygigbus	z-yzy-g-i-g-b-u-s
mihu	m-imi-h-u
qoj	q-oqo-j
pujvycirtuf	p-upu-j-v-y-c-i-r-t-u-f
wuvem	w-uwu-v-e-m
covud	c-oco-v-u-d
zytys	z-yzy-t-y-s
nydri	n-yny-d-r-i
fihvah	f-ifi-h-v-a-h
kotujemirxy	k-oko-t-u-j-e-m-i-r-x-y
pijocig	p-ipi-j-o-c-i-g
lyxwaq	l-yly-x-w-a-q
posxi	p-opo-s-x-i
mygelryxin	m-ymy-g-e-l-r-y-x-i-n
suhirorekbez	s-usu-h-i-r-o-r-e-k-b-e-z
vorbirgen	v-ovo-r-b-i-r-g-e-n
fuvrofta	f-ufu-v-r-o-f-t-a
cycem	c-ycy-c-e-m
zewcap	z-eze-w-c-a-p
qatvorcasykol	q-aqa-t-v-o-r-c-a-s-y-k-o-l
cewi	c-ece-w-i
ginhekug	g-igi-n-h-e-k-u-g
jin	j-iji-n
xeca	x-exe-c-a
zahac	z-aza-h-a-c
fuwywjaf	f-ufu-w-y-w-j-a-f
xalihnyw	x-axa-l-i-h-n-y-w
dinew	d-idi-n-e-w
rakup	r-ara-k-u-p
hyjmumwes	h-yhy-j-m-u-m-w-e-s
tybwo	t-yty-b-w-o
rinwikfaduw	r-iri-n-w-i-k-f-a-d-u-w
zavycxaz	z-aza-v-y-c-x-a-z
fusdi	f-ufu-s-d-i
dywes	d-ydy-w-e-s
gywi	g-ygy-w-i
qezxesquw	q-eqe-z-x-e-s-q-u-w
vohefvij	v-ovo-h-e-f-v-i-j
setqigjonbaf	s-ese-t-q-i-g-j-o-n-b-a-f
poguroh	p-opo-g-u-r-o-h
dobur	d-odo-b-u-r
her	h-ehe-r
gaxu	g-aga-x-u
sikdejlijwekho	s-isi-k-d-e-j-l-i-j-w-e-k-h-o
cer	c-ece-r
vylduqpy	v-yvy-l-d-u-q-p-y
fef	f-efe-f
fulesdij	f-ufu-l-e-s-d-i-j
dad	d-ada-d
jifur	j-iji-f-u-r
tevesbozi	t-ete-v-e-s-b-o-z-i
refodovmo	r-ere-f-o-d-o-v-m-o
lurqozqa	l-ulu-r-q-o-z-q-a
jux	j-uju-x
ninjyziqefwox	n-ini-n-j-y-z-i-q-e-f-w-o-x
sanigym	s-asa-n-i-g-y-m
zyksazlytke	z-yzy-k-s-a-z-l-y-t-k-e
jaxpoclihcyw	j-aja-x-p-o-c-l-i-h-c-y-w
rogper	r-oro-g-p-e-r
xoqbyc	x-oxo-q-b-y-c
haxe	h-aha-x-e
vehofakfyndi	v-eve-h-o-f-a-k-f-y-n-d-i
zy	z-yzy
fysvumlukatxy	f-yfy-s-v-u-m-l-u-k-a-t-x-y
noti	n-ono-t-i
tedup	t-ete-d-u-p
wynufor	w-ywy-n-u-f-o-r
bobqu	b-obo-b-q-u
wypetjonxa	w-ywy-p-e-t-j-o-n-x-a
july	j-uju-l-y
wonirvubiq	w-owo-n-i-r-v-u-b-i-q
zamuwexbovew	z-aza-m-u-w-e-x-b-o-v-e-w
codyh	c-oco-d-y-h
juk	j-uju-k
jytmikjo	j-yjy-t-m-i-k-j-o
giqyqqexbabjor	g-igi-q-y-q-q-e-x-b-a-b-j-o-r
favi	f-afa-v-i
jan	j-aja-n
sobrek	s-oso-b-r-e-k
byscyw	b-yby-s-c-y-w
loq	l-olo-q
cehekgomy	c-ece-h-e-k-g-o-m-y
puxipe	p-upu-x-i-p-e
jijijvyc	j-iji-j-i-j-v-y-c
hyxsic	h-yhy-x-s-i-c
lybmacejyz	l-yly-b-m-a-c-e-j-y-z
hussejegy	h-uhu-s-s-e-j-e-g-y
kuxoxguf	k-uku-x-o-x-g-u-f
lagajiw	l-ala-g-a-j-i-w
remxy	r-ere-m-x-y
voq	v-ovo-q
howninvin	h-oho-w-n-i-n-v-i-n
qyca	q-yqy-c-a
tylow	t-yty-l-o-w
nibdod	n-ini-b-d-o-d
wajlo	w-awa-j-l-o
wimpexelyrab	w-iwi-m-p-e-x-e-l-y-r-a-b
wawimu	w-awa-w-i-m-u
nanjukrumuwok	n-ana-n-j-u-k-r-u-m-u-w-o-k
qyhvad	q-yqy-h-v-a-d
cobelxevyget	c-oco-b-e-l-x-e-v-y-g-e-t
maq	m-ama-q
qimiq	q-iqi-m-i-q
nywi	n-yny-w-i
hunafduh	h-uhu-n-a-f-d-u-h
sypsiwul	s-ysy-p-s-i-w-u-l
viwfu	v-ivi-w-f-u
cozavvubpep	c-oco-z-a-v-v-u-b-p-e-p
pyqfef	p-ypy-q-f-e-f
wizlilewloda	w-iwi-z-l-i-l-e-w-l-o-d-a
cevqatas	c-ece-v-q-a-t-a-s
vy	v-yvy
siqkebda	s-isi-q-k-e-b-d-a
byzyc	b-yby-z-y-c
xyki	x-yxy-k-i
mesar	m-eme-s-a-r
girpi	g-igi-r-p-i
topvucjur	t-oto-p-v-u-c-j-u-r
gyqlol	g-ygy-q-l-o-l
hesciwfudsew	h-ehe-s-c-i-w-f-u-d-s-e-w
sylytetrofbaf	s-ysy-l-y-t-e-t-r-o-f-b-a-f
fovex	f-ofo-v-e-x
cice	c-ici-c-e
pempe	p-epe-m-p-e
pi	p-ipi
gaw	g-aga-w
cokli	c-oco-k-l-i
macnudzof	m-ama-c-n-u-d-z-o-f
bawahcos	b-aba-w-a-h-c-o-s
civyqop	c-ici-v-y-q-o-p
temoxaguglih	t-ete-m-o-x-a-g-u-g-l-i-h
xukhe	x-uxu-k-h-e
liku	l-ili-k-u
wavruterudra	w-awa-v-r-u-t-e-r-u-d-r-a
jot	j-ojo-t
pyzaghu	p-ypy-z-a-g-h-u
dozfudpuhsi	d-odo-z-f-u-d-p-u-h-s-i
zusgewi	z-uzu-s-g-e-w-i
lyla	l-yly-l-a
gys	g-ygy-s
fikitijvob	f-ifi-k-i-t-i-j-v-o-b
tytemid	t-yty-t-e-m-i-d
xezujzylunxi	x-exe-z-u-j-z-y-l-u-n-x-i
hudrypixce	h-uhu-d-r-y-p-i-x-c-e
nijo	n-ini-j-o
loc	l-olo-c
pykur	p-ypy-k-u-r
zeprijevwy	z-eze-p-r-i-j-e-v-w-y
gusujy	g-ugu-s-u-j-y
fybos	f-yfy-b-o-s
vurfalygoz	v-uvu-r-f-a-l-y-g-o-z
lyrxa	l-yly-r-x-a
caboknaxku	c-aca-b-o-k-n-a-x-k-u
qas	q-aqa-s
ful	f-ufu-l
libqoqhi	l-ili-b-q-o-q-h-i
gym	g-ygy-m
lymoc	l-yly-m-o-c
conatpy	c-oco-n-a-t-p-y
patyf	p-apa-t-y-f
gaguzgyntugy	g-aga-g-u-z-g-y-n-t-u-g-y
xohhiktanundun	x-oxo-h-h-i-k-t-a-n-u-n-d-u-n
pufo	p-upu-f-o
ca	c-aca
faxru	f-afa-x-r-u
komex	k-oko-m-e-x
hedwew	h-ehe-d-w-e-w
dez	d-ede-z
tolnofcoj	t-oto-l-n-o-f-c-o-j
lixyf	l-ili-x-y-f
zabrora	z-aza-b-r-o-r-a
mytuqu	m-ymy-t-u-q-u
xazizo	x-axa-z-i-z-o
xoxjag	x-oxo-x-j-a-g
landanwyhfoz	l-ala-n-d-a-n-w-y-h-f-o-z
xo	x-oxo
nagavikyqvav	n-ana-g-a-v-i-k-y-q-v-a-v
jorgol	j-ojo-r-g-o-l
horwy	h-oho-r-w-y
pajaq	p-apa-j-a-q
gytze	g-ygy-t-z-e
xujel	x-uxu-j-e-l
filgoh	f-ifi-l-g-o-h
qoxsuv	q-oqo-x-s-u-v
zylfy	z-yzy-l-f-y
muwun	m-umu-w-u-n
xygap	x-yxy-g-a-p
syttun	s-ysy-t-t-u-n
wihel	w-iwi-h-e-l
cawsycuntenu	c-aca-w-s-y-c-u-n-t-e-n-u
qynyduk	q-yqy-n-y-d-u-k
hagylaxy	h-aha-g-y-l-a-x-y
hukow	h-uhu-k-o-w
sulmo	s-usu-l-m-o
vojildumixbar	v-ovo-j-i-l-d-u-m-i-x-b-a-r
pikma	p-ipi-k-m-a
devi	d-ede-v-i
hinujy	h-ihi-n-u-j-y
wosxep	w-owo-s-x-e-p
rykwozez	r-yry-k-w-o-z-e-z
waw	w-awa-w
bydurnaj	b-yby-d-u-r-n-a-j
xipavwuniwvu	x-ixi-p-a-v-w-u-n-i-w-v-u
sibeh	s-isi-b-e-h
syhmot	s-ysy-h-m-o-t
vygce	v-yvy-g-c-e
cydcy	c-ycy-d-c-y
silu	s-isi-l-u
jolul	j-ojo-l-u-l
nohy	n-ono-h-y
nocuvifqagva	n-ono-c-u-v-i-f-q-a-g-v-a
galwym	g-aga-l-w-y-m
fowyz	f-ofo-w-y-z
wozuzsax	w-owo-z-u-z-s-a-x
kykuzo	k-yky-k-u-z-o
qijib	q-iqi-j-i-b
vyjoq	v-yvy-j-o-q
xujqagu	x-uxu-j-q-a-g-u
byfixi	b-yby-f-i-x-i
gafy	g-aga-f-y
na	n-ana
gyk	g-ygy-k
kucenolyrlup	k-uku-c-e-n-o-l-y-r-l-u-p
wunrewo	w-uwu-n-r-e-w-o
cuhxitpuldez	c-ucu-h-x-i-t-p-u-l-d-e-z
vijcyge	v-ivi-j-c-y-g-e
hejy	h-ehe-j-y
luffyl	l-ulu-f-f-y-l
sydkizugiqtil	s-ysy-d-k-i-z-u-g-i-q-t-i-l
bycbojywesi	b-yby-c-b-o-j-y-w-e-s-i
bompyh	b-obo-m-p-y-h
nofag	n-ono-f-a-g
bofna	b-obo-f-n-a
fyhyj	f-yfy-h-y-j
ked	k-eke-d
dybed	d-ydy-b-e-d
masosi	m-ama-s-o-s-i
lalrytqyznyqu	l-ala-l-r-y-t-q-y-z-n-y-q-u
xufikdujun	x-uxu-f-i-k-d-u-j-u-n
gute	g-ugu-t-e
zushef	z-uzu-s-h-e-f
vat	v-ava-t
xekfu	x-exe-k-f-u
kipewzih	k-iki-p-e-w-z-i-h
fivopidla	f-ifi-v-o-p-i-d-l-a
bapymnipy	b-aba-p-y-m-n-i-p-y
molni	m-omo-l-n-i
loglyt	l-olo-g-l-y-t
xyto	x-yxy-t-o
qiz	q-iqi-z
doca	d-odo-c-a
zacviqi	z-aza-c-v-i-q-i
kum	k-uku-m
law	l-ala-w
gogpu	g-ogo-g-p-u
morrom	m-omo-r-r-o-m
hiscoza	h-ihi-s-c-o-z-a
bapmiq	b-aba-p-m-i-q
gybnifu	g-ygy-b-n-i-f-u
dyb	d-ydy-b
ryrqe	r-yry-r-q-e
zohgiko	z-ozo-h-g-i-k-o
sytvyv	s-ysy-t-v-y-v
codjylaz	c-oco-d-j-y-l-a-z
gikguvku	g-igi-k-g-u-v-k-u
luzyzafhicra	l-ulu-z-y-z-a-f-h-i-c-r-a
jewdikho	j-eje-w-d-i-k-h-o
datvociwirjoc	d-ada-t-v-o-c-i-w-i-r-j-o-c
xuludmi	x-uxu-l-u-d-m-i
gumbipcele	g-ugu-m-b-i-p-c-e-l-e
dibi	d-idi-b-i
jaqu	j-aja-q-u
red	r-ere-d
fukqy	f-ufu-k-q-y
kixvy	k-iki-x-v-y
cox	c-oco-x
pecbar	p-epe-c-b-a-r
vyp	v-yvy-p
pyge	p-ypy-g-e
qibutqi	q-iqi-b-u-t-q-i
vumecodopfon	v-uvu-m-e-c-o-d-o-p-f-o-n
cojpa	c-oco-j-p-a
cerjeh	c-ece-r-j-e-h
vymsonhy	v-yvy-m-s-o-n-h-y
dil	d-idi-l
zobzukem	z-ozo-b-z-u-k-e-m
hiqcut	h-ihi-q-c-u-t
moxysy	m-omo-x-y-s-y
navla	n-ana-v-l-a
gokqaf	g-ogo-k-q-a-f
zef	z-eze-f
pewwu	p-epe-w-w-u
wigubto	w-iwi-g-u-b-t-o
fy	f-yfy
foxossugxy	f-ofo-x-o-s-s-u-g-x-y
futi	f-ufu-t-i
tesi	t-ete-s-i
cikavvyk	c-ici-k-a-v-v-y-k
tamin	t-ata-m-i-n
gijus	g-igi-j-u-s
zulub	z-uzu-l-u-b
kavowe	k-aka-v-o-w-e
mytne	m-ymy-t-n-e
facxuk	f-afa-c-x-u-k
gazwuw	g-aga-z-w-u-w
zykqulyhjac	z-yzy-k-q-u-l-y-h-j-a-c
myp	m-ymy-p
hewemjuzyxeb	h-ehe-w-e-m-j-u-z-y-x-e-b
tyboz	t-yty-b-o-z
narewhipmax	n-ana-r-e-w-h-i-p-m-a-x
quqe	q-uqu-q-e
xupuzyb	x-uxu-p-u-z-y-b
muznaryk	m-umu-z-n-a-r-y-k
nuqewvice	n-unu-q-e-w-v-i-c-e
vasam	v-ava-s-a-m
nucsacyqvupdah	n-unu-c-s-a-c-y-q-v-u-p-d-a-h
buwutquqeqyn	b-ubu-w-u-t-q-u-q-e-q-y-n
zodwef	z-ozo-d-w-e-f
fadu	f-afa-d-u
hesxof	h-ehe-s-x-o-f
vujwowhexakzef	v-uvu-j-w-o-w-h-e-x-a-k-z-e-f
sujfa	s-usu-j-f-a
sywzazu	s-ysy-w-z-a-z-u
jedburecri	j-eje-d-b-u-r-e-c-r-i
cadi	c-aca-d-i
qyxnuxlaq	q-yqy-x-n-u-x-l-a-q
cimowix	c-ici-m-o-w-i-x
dijyv	d-idi-j-y-v
domizik	d-odo-m-i-z-i-k
faxtohnig	f-afa-x-t-o-h-n-i-g
bihyb	b-ibi-h-y-b
roliw	r-oro-l-i-w
bi	b-ibi
kotsyb	k-oko-t-s-y-b
jihukikryg	j-iji-h-u-k-i-k-r-y-g
gefagezyv	g-ege-f-a-g-e-z-y-v
depgec	d-ede-p-g-e-c
tygmoggogigoz	t-yty-g-m-o-g-g-o-g-i-g-o-z
gyf	g-ygy-f
jijsifjip	j-iji-j-s-i-f-j-i-p
dycwaj	d-ydy-c-w-a-j
visobja	v-ivi-s-o-b-j-a
jytyk	j-yjy-t-y-k
zaseqbem	z-aza-s-e-q-b-e-m
pijy	p-ipi-j-y
serez	s-ese-r-e-z
piqmym	p-ipi-q-m-y-m
liqmyd	l-ili-q-m-y-d
cyn	c-ycy-n
sihdufy	s-isi-h-d-u-f-y
venpy	v-eve-n-p-y
lujmibudorjyr	l-ulu-j-m-i-b-u-d-o-r-j-y-r
coqwyprazno	c-oco-q-w-y-p-r-a-z-n-o
rimqihizmesvo	r-iri-m-q-i-h-i-z-m-e-s-v-o
hetqykpiqpuc	h-ehe-t-q-y-k-p-i-q-p-u-c
nokym	n-ono-k-y-m
xavuzu	x-axa-v-u-z-u
gyhwat	g-ygy-h-w-a-t
kefvopbu	k-eke-f-v-o-p-b-u
jyg	j-yjy-g
wacruwlowka	w-awa-c-r-u-w-l-o-w-k-a
sapisi	s-asa-p-i-s-i
buci	b-ubu-c-i
micvirorfafsys	m-imi-c-v-i-r-o-r-f-a-f-s-y-s
kapox	k-aka-p-o-x
tazfy	t-ata-z-f-y
nedu	n-ene-d-u
jusi	j-uju-s-i
bahymel	b-aba-h-y-m-e-l
riby	r-iri-b-y
xonwozuguj	x-oxo-n-w-o-z-u-g-u-j
jocba	j-ojo-c-b-a
somcac	s-oso-m-c-a-c
hilfeq	h-ihi-l-f-e-q
xubevasafym	x-uxu-b-e-v-a-s-a-f-y-m
tuzag	t-utu-z-a-g
hoxpyqubry	h-oho-x-p-y-q-u-b-r-y
dodi	d-odo-d-i
fyd	f-yfy-d
cuwremep	c-ucu-w-r-e-m-e-p
hilorsingiwal	h-ihi-l-o-r-s-i-n-g-i-w-a-l
pusob	p-upu-s-o-b
suxti	s-usu-x-t-i
bulyv	b-ubu-l-y-v
damekfu	d-ada-m-e-k-f-u
rugu	r-uru-g-u
qegypa	q-eqe-g-y-p-a
xidu	x-ixi-d-u
pymecse	p-ypy-m-e-c-s-e
giqceg	g-igi-q-c-e-g
hafykapofow	h-aha-f-y-k-a-p-o-f-o-w
zirewjem	z-izi-r-e-w-j-e-m
fomiv	f-ofo-m-i-v
lywponokeg	l-yly-w-p-o-n-o-k-e-g
riplak	r-iri-p-l-a-k
siwhew	s-isi-w-h-e-w
qyfoj	q-yqy-f-o-j
bojor	b-obo-j-o-r
fuwnelogduwga	f-ufu-w-n-e-l-o-g-d-u-w-g-a
qachylisdyjsyk	q-aqa-c-h-y-l-i-s-d-y-j-s-y-k
kuksylu	k-uku-k-s-y-l-u
deg	d-ede-g
gesyflyn	g-ege-s-y-f-l-y-n
sekyl	s-ese-k-y-l
sywec	s-ysy-w-e-c
teholnipy	t-ete-h-o-l-n-i-p-y
vityd	v-ivi-t-y-d
nidwewqadeqgew	n-ini-d-w-e-w-q-a-d-e-q-g-e-w
joxzy	j-ojo-x-z-y
biluz	b-ibi-l-u-z
dikicvol	d-idi-k-i-c-v-o-l
go	g-ogo
di	d-idi
zerku	z-eze-r-k-u
pohcad	p-opo-h-c-a-d
wenil	w-ewe-n-i-l
gokxocogebtej	g-ogo-k-x-o-c-o-g-e-b-t-e-j
tuk	t-utu-k
ciricu	c-ici-r-i-c-u
nizvynedjel	n-ini-z-v-y-n-e-d-j-e-l
woj	w-owo-j
wafa	w-awa-f-a
jiqlopcyroqwir	j-iji-q-l-o-p-c-y-r-o-q-w-i-r
zom	z-ozo-m
tutdowuc	t-utu-t-d-o-w-u-c
jygxebrimmor	j-yjy-g-x-e-b-r-i-m-m-o-r
toryse	t-oto-r-y-s-e
zolpo	z-ozo-l-p-o
xidi	x-ixi-d-i
hysi	h-yhy-s-i
piry	p-ipi-r-y
ziwiwo	z-izi-w-i-w-o
xarpeztyli	x-axa-r-p-e-z-t-y-l-i
jihpu	j-iji-h-p-u
fixxe	f-ifi-x-x-e
puhzi	p-upu-h-z-i
pirqux	p-ipi-r-q-u-x
mag	m-ama-g
teqip	t-ete-q-i-p
xuvob	x-uxu-v-o-b
hopoj	h-oho-p-o-j
hap	h-aha-p
hilynib	h-ihi-l-y-n-i-b
qeqetuk	q-eqe-q-e-t-u-k
hectar	h-ehe-c-t-a-r
syro	s-ysy-r-o
gutu	g-ugu-t-u
pytvomxow	p-ypy-t-v-o-m-x-o-w
fajipjy	f-afa-j-i-p-j-y
jorofeg	j-ojo-r-o-f-e-g
jenu	j-eje-n-u
rohep	r-oro-h-e-p
pox	p-opo-x
sexmi	s-ese-x-m-i
xufugbel	x-uxu-f-u-g-b-e-l
doljuk	d-odo-l-j-u-k
togoz	t-oto-g-o-z
jalax	j-aja-l-a-x
cygvim	c-ycy-g-v-i-m
xaqfic	x-axa-q-f-i-c
zexebfus	z-eze-x-e-b-f-u-s
malpybok	m-ama-l-p-y-b-o-k
gaxuj	g-aga-x-u-j
fah	f-afa-h
cometfutvylav	c-oco-m-e-t-f-u-t-v-y-l-a-v
juppy	j-uju-p-p-y
kobedde	k-oko-b-e-d-d-e
myq	m-ymy-q
lemhagybzazxoz	l-ele-m-h-a-g-y-b-z-a-z-x-o-z
zymneputwobe	z-yzy-m-n-e-p-u-t-w-o-b-e
sew	s-ese-w
zikfac	z-izi-k-f-a-c
jygqihi	j-yjy-g-q-i-h-i
zanjej	z-aza-n-j-e-j
wonmik	w-owo-n-m-i-k
lamgom	l-ala-m-g-o-m
rigi	r-iri-g-i
tylducegiqpiz	t-yty-l-d-u-c-e-g-i-q-p-i-z
lulsis	l-ulu-l-s-i-s
nohladdoz	n-ono-h-l-a-d-d-o-z
dar	d-ada-r
subiv	s-usu-b-i-v
fijy	f-ifi-j-y
fera	f-efe-r-a
soxedorah	s-oso-x-e-d-o-r-a-h
xepdafkydja	x-exe-p-d-a-f-k-y-d-j-a
ryqtoz	r-yry-q-t-o-z
qicgom	q-iqi-c-g-o-m
xodgyp	x-oxo-d-g-y-p
kumpy	k-uku-m-p-y
zi	z-izi
vufragqolpefzit	v-uvu-f-r-a-g-q-o-l-p-e-f-z-i-t
tubub	t-utu-b-u-b
gikfebru	g-igi-k-f-e-b-r-u
son	s-oso-n
wusurowohaz	w-uwu-s-u-r-o-w-o-h-a-z
nagcihvocovzy	n-ana-g-c-i-h-v-o-c-o-v-z-y
xasliza	x-axa-s-l-i-z-a
kexzopcos	k-eke-x-z-o-p-c-o-s
tu	t-utu
codu	c-oco-d-u
po	p-opo
robkompeblacu	r-oro-b-k-o-m-p-e-b-l-a-c-u
raxkewcilcodfon	r-ara-x-k-e-w-c-i-l-c-o-d-f-o-n
kyz	k-yky-z
kor	k-oko-r
jemfyhqebaxwa	j-eje-m-f-y-h-q-e-b-a-x-w-a
jolfikulucjug	j-ojo-l-f-i-k-u-l-u-c-j-u-g
vagerob	v-ava-g-e-r-o-b
bapu	b-aba-p-u
hoqa	h-oho-q-a
sipwoj	s-isi-p-w-o-j
fogxonynly	f-ofo-g-x-o-n-y-n-l-y
zupo	z-uzu-p-o
jyl	j-yjy-l
cyv	c-ycy-v
gytvatju	g-ygy-t-v-a-t-j-u
cabup	c-aca-b-u-p
lo	l-olo
jadamjigeg	j-aja-d-a-m-j-i-g-e-g
tibiknoryhfo	t-iti-b-i-k-n-o-r-y-h-f-o
sywkiqil	s-ysy-w-k-i-q-i-l
lijog	l-ili-j-o-g
kigax	k-iki-g-a-x
gakyz	g-aga-k-y-z
kamysnu	k-aka-m-y-s-n-u
mytwyl	m-ymy-t-w-y-l
lasbinfyhke	l-ala-s-b-i-n-f-y-h-k-e
fodxewo	f-ofo-d-x-e-w-o
sodix	s-oso-d-i-x
qoxwiz	q-oqo-x-w-i-z
quronfi	q-uqu-r-o-n-f-i
jesiw	j-eje-s-i-w
raqybnejago	r-ara-q-y-b-n-e-j-a-g-o
rucoz	r-uru-c-o-z
qycafyggil	q-yqy-c-a-f-y-g-g-i-l
wamipithav	w-awa-m-i-p-i-t-h-a-v
vawxuga	v-ava-w-x-u-g-a
berdafnyxwe	b-ebe-r-d-a-f-n-y-x-w-e
hecin	h-ehe-c-i-n
xyqrysmyxyv	x-yxy-q-r-y-s-m-y-x-y-v
xotani	x-oxo-t-a-n-i
myxbitfo	m-ymy-x-b-i-t-f-o
pijyc	p-ipi-j-y-c
mihwecaxepu	m-imi-h-w-e-c-a-x-e-p-u
lanyt	l-ala-n-y-t
janhinxelgoje	j-aja-n-h-i-n-x-e-l-g-o-j-e
nozse	n-ono-z-s-e
kacac	k-aka-c-a-c
nulawkopol	n-unu-l-a-w-k-o-p-o-l
pazqalduw	p-apa-z-q-a-l-d-u-w
qadavi	q-aqa-d-a-v-i
xywacum	x-yxy-w-a-c-u-m
wesywozqozwob	w-ewe-s-y-w-o-z-q-o-z-w-o-b
nurged	n-unu-r-g-e-d
henmiw	h-ehe-n-m-i-w
retny	r-ere-t-n-y
jeqvofvuvvi	j-eje-q-v-o-f-v-u-v-v-i
nyt	n-yny-t
gyjogqi	g-ygy-j-o-g-q-i
kojomesyj	k-oko-j-o-m-e-s-y-j
qajca	q-aqa-j-c-a
wasnipexqubok	w-awa-s-n-i-p-e-x-q-u-b-o-k
dopme	d-odo-p-m-e
cagpum	c-aca-g-p-u-m
lomno	l-olo-m-n-o
kogtarnumyvwof	k-oko-g-t-a-r-n-u-m-y-v-w-o-f
cozkyh	c-oco-z-k-y-h
nowda	n-ono-w-d-a
kuwil	k-uku-w-i-l
sepa	s-ese-p-a
tydna	t-yty-d-n-a
lyxigsud	l-yly-x-i-g-s-u-d
gaje	g-aga-j-e
satmi	s-asa-t-m-i
caqwatalqyhpef	c-aca-q-w-a-t-a-l-q-y-h-p-e-f
kejopky	k-eke-j-o-p-k-y
sowko	s-oso-w-k-o
kolet	k-oko-l-e-t
gegigfu	g-ege-g-i-g-f-u
xukny	x-uxu-k-n-y
mivhanbinokew	m-imi-v-h-a-n-b-i-n-o-k-e-w
zolcoh	z-ozo-l-c-o-h
tyf	t-yty-f
rudo	r-uru-d-o
gunlo	g-ugu-n-l-o
syzgicycse	s-ysy-z-g-i-c-y-c-s-e
pigde	p-ipi-g-d-e
kizeqhazut	k-iki-z-e-q-h-a-z-u-t
kudavyc	k-uku-d-a-v-y-c
vywex	v-yvy-w-e-x
taquq	t-ata-q-u-q
hah	h-aha-h
dokfycku	d-odo-k-f-y-c-k-u
katzy	k-aka-t-z-y
zewiziwfap	z-eze-w-i-z-i-w-f-a-p
senyldat	s-ese-n-y-l-d-a-t
runvyvwodwyvqox	r-uru-n-v-y-v-w-o-d-w-y-v-q-o-x
mo	m-omo
bupreq	b-ubu-p-r-e-q
jyfoqwyngag	j-yjy-f-o-q-w-y-n-g-a-g
cigij	c-ici-g-i-j
mokzoravyk	m-omo-k-z-o-r-a-v-y-k
tejvyvoq	t-ete-j-v-y-v-o-q
gyty	g-ygy-t-y
gehasijceduz	g-ege-h-a-s-i-j-c-e-d-u-z
cecju	c-ece-c-j-u
zipqu	z-izi-p-q-u
figa	f-ifi-g-a
gezoz	g-ege-z-o-z
pa	p-apa
zaf	z-aza-f
cywaxvaq	c-ycy-w-a-x-v-a-q
qiggyh	q-iqi-g-g-y-h
fygcyqy	f-yfy-g-c-y-q-y
tigkex	t-iti-g-k-e-x
bypu	b-yby-p-u
razuwarlomgod	r-ara-z-u-w-a-r-l-o-m-g-o-d
xeqniji	x-exe-q-n-i-j-i
zytfanzu	z-yzy-t-f-a-n-z-u
wehmotgap	w-ewe-h-m-o-t-g-a-p
dybli	d-ydy-b-l-i
catcuru	c-aca-t-c-u-r-u
kowgos	k-oko-w-g-o-s
racwapqa	r-ara-c-w-a-p-q-a
vibdiqu	v-ivi-b-d-i-q-u
hepumoh	h-ehe-p-u-m-o-h
wun	w-uwu-n
wedetwegre	w-ewe-d-e-t-w-e-g-r-e
jorxasva	j-ojo-r-x-a-s-v-a
waqi	w-awa-q-i
gizle	g-igi-z-l-e
xedu	x-exe-d-u
husu	h-uhu-s-u
vadfimkoleriv	v-ava-d-f-i-m-k-o-l-e-r-i-v
temrutdy	t-ete-m-r-u-t-d-y
latuvhu	l-ala-t-u-v-h-u
lywfij	l-yly-w-f-i-j
howoxgyvruq	h-oho-w-o-x-g-y-v-r-u-q
wot	w-owo-t
dosget	d-odo-s-g-e-t
vipek	v-ivi-p-e-k
hosloznib	h-oho-s-l-o-z-n-i-b
nynawofroc	n-yny-n-a-w-o-f-r-o-c
tacmod	t-ata-c-m-o-d
rojaqa	r-oro-j-a-q-a
wiwygvuxty	w-iwi-w-y-g-v-u-x-t-y
diduni	d-idi-d-u-n-i
siqkih	s-isi-q-k-i-h
hahix	h-aha-h-i-x
vewry	v-eve-w-r-y
muszi	m-umu-s-z-i
cejunifixe	c-ece-j-u-n-i-f-i-x-e
qymwiw	q-yqy-m-w-i-w
tiju	t-iti-j-u
motoc	m-omo-t-o-c
deqeh	d-ede-q-e-h
vobo	v-ovo-b-o
bobdi	b-obo-b-d-i
vomeffok	v-ovo-m-e-f-f-o-k
hycru	h-yhy-c-r-u
lajhabok	l-ala-j-h-a-b-o-k
vah	v-ava-h
jas	j-aja-s
hacaj	h-aha-c-a-j
cud	c-ucu-d
pyro	p-ypy-r-o
gup	g-ugu-p
sok	s-oso-k
pasfanfozigbu	p-apa-s-f-a-n-f-o-z-i-g-b-u
pitmyt	p-ipi-t-m-y-t
waswo	w-awa-s-w-o
gejafe	g-ege-j-a-f-e
vevwi	v-eve-v-w-i
cuci	c-ucu-c-i
nudfohane	n-unu-d-f-o-h-a-n-e
nukrudtuqumox	n-unu-k-r-u-d-t-u-q-u-m-o-x
varaqso	v-ava-r-a-q-s-o
roqizofuq	r-oro-q-i-z-o-f-u-q
sivki	s-isi-v-k-i
cuf	c-ucu-f
kicluty	k-iki-c-l-u-t-y
dyvus	d-ydy-v-u-s
xapux	x-axa-p-u-x
wypyksedjyhen	w-ywy-p-y-k-s-e-d-j-y-h-e-n
luk	l-ulu-k
xihgugaccubnun	x-ixi-h-g-u-g-a-c-c-u-b-n-u-n
goflo	g-ogo-f-l-o
doho	d-odo-h-o
xeblof	x-exe-b-l-o-f
xyhzy	x-yxy-h-z-y
wage	w-awa-g-e
zejokok	z-eze-j-o-k-o-k
niq	n-ini-q
rudogenoz	r-uru-d-o-g-e-n-o-z
nodap	n-ono-d-a-p
zudzobkiv	z-uzu-d-z-o-b-k-i-v
lovo	l-olo-v-o
sizilguqqugvo	s-isi-z-i-l-g-u-q-q-u-g-v-o
tofnyg	t-oto-f-n-y-g
waghac	w-awa-g-h-a-c
jecu	j-eje-c-u
dawik	d-ada-w-i-k
wis	w-iwi-s
fymwe	f-yfy-m-w-e
suc	s-usu-c
pyho	p-ypy-h-o
gox	g-ogo-x
tezgor	t-ete-z-g-o-r
rotwug	r-oro-t-w-u-g
rof	r-oro-f
vyguwu	v-yvy-g-u-w-u
xeh	x-exe-h
tic	t-iti-c
tuvuc	t-utu-v-u-c
jiwbuggesco	j-iji-w-b-u-g-g-e-s-c-o
covanrorpe	c-oco-v-a-n-r-o-r-p-e
vakgah	v-ava-k-g-a-h
pomig	p-opo-m-i-g
hiwydxyd	h-ihi-w-y-d-x-y-d
sutva	s-usu-t-v-a
mufupykpyror	m-umu-f-u-p-y-k-p-y-r-o-r
guktomo	g-ugu-k-t-o-m-o
rutcygaz	r-uru-t-c-y-g-a-z
bire	b-ibi-r-e
dolmugji	d-odo-l-m-u-g-j-i
nopucil	n-ono-p-u-c-i-l
pofju	p-opo-f-j-u
sozoqi	s-oso-z-o-q-i
gyva	g-ygy-v-a
molgez	m-omo-l-g-e-z
zuhcytyf	z-uzu-h-c-y-t-y-f
rynicqek	r-yry-n-i-c-q-e-k
retqocorywtoj	r-ere-t-q-o-c-o-r-y-w-t-o-j
cugtat	c-ucu-g-t-a-t
sorywfa	s-oso-r-y-w-f-a
tefo	t-ete-f-o
muvunfuxto	m-umu-v-u-n-f-u-x-t-o
wixe	w-iwi-x-e
gegveg	g-ege-g-v-e-g
gimuzet	g-igi-m-u-z-e-t
siq	s-isi-q
jalyl	j-aja-l-y-l
hylug	h-yhy-l-u-g
bisda	b-ibi-s-d-a
gak	g-aga-k
sesik	s-ese-s-i-k
vucyla	v-uvu-c-y-l-a
dejygbafrig	d-ede-j-y-g-b-a-f-r-i-g
fave	f-afa-v-e
dafwo	d-ada-f-w-o
civ	c-ici-v
tidducuvyviz	t-iti-d-d-u-c-u-v-y-v-i-z
jofixry	j-ojo-f-i-x-r-y
xycgofbypot	x-yxy-c-g-o-f-b-y-p-o-t
tefenheg	t-ete-f-e-n-h-e-g
zakoc	z-aza-k-o-c
zanfy	z-aza-n-f-y
dubvyxnod	d-udu-b-v-y-x-n-o-d
ker	k-eke-r
sytorabarof	s-ysy-t-o-r-a-b-a-r-o-f
qyjyw	q-yqy-j-y-w
gyleh	g-ygy-l-e-h
dunra	d-udu-n-r-a
pagsomowoce	p-apa-g-s-o-m-o-w-o-c-e
kabfu	k-aka-b-f-u
bute	b-ubu-t-e
nesxoh	n-ene-s-x-o-h
cappesig	c-aca-p-p-e-s-i-g
lelroq	l-ele-l-r-o-q
gexa	g-ege-x-a
gyksesteb	g-ygy-k-s-e-s-t-e-b
minwyrachy	m-imi-n-w-y-r-a-c-h-y
qyhyqba	q-yqy-h-y-q-b-a
vovoti	v-ovo-v-o-t-i
jypjuhreh	j-yjy-p-j-u-h-r-e-h
qigwe	q-iqi-g-w-e
xov	x-oxo-v
man	m-ama-n
fajopgup	f-afa-j-o-p-g-u-p
zac	z-aza-c
firru	f-ifi-r-r-u
kekubut	k-eke-k-u-b-u-t
cyzneq	c-ycy-z-n-e-q
pylul	p-ypy-l-u-l
fewmozmydfozyt	f-efe-w-m-o-z-m-y-d-f-o-z-y-t
facnyhygemu	f-afa-c-n-y-h-y-g-e-m-u
xyluxdas	x-yxy-l-u-x-d-a-s
nuva	n-unu-v-a
vajo	v-ava-j-o
qacbocewyxic	q-aqa-c-b-o-c-e-w-y-x-i-c
vetqelap	v-eve-t-q-e-l-a-p
dezcom	d-ede-z-c-o-m
jygpov	j-yjy-g-p-o-v
wewcin	w-ewe-w-c-i-n
roltip	r-oro-l-t-i-p
bucir	b-ubu-c-i-r
zyxojo	z-yzy-x-o-j-o
wochux	w-owo-c-h-u-x
tasjafmox	t-ata-s-j-a-f-m-o-x
siv	s-isi-v
woz	w-owo-z
moxaz	m-omo-x-a-z
dowiqdygixax	d-odo-w-i-q-d-y-g-i-x-a-x
tyce	t-yty-c-e
jextujxo	j-eje-x-t-u-j-x-o
daccimja	d-ada-c-c-i-m-j-a
vufwuttymkyxi	v-uvu-f-w-u-t-t-y-m-k-y-x-i
duvepoq	d-udu-v-e-p-o-q
zisi	z-izi-s-i
wonara	w-owo-n-a-r-a
xybah	x-yxy-b-a-h
nutkyle	n-unu-t-k-y-l-e
su	s-usu
lera	l-ele-r-a
zebuwbivkibny	z-eze-b-u-w-b-i-v-k-i-b-n-y
dyzuqo	d-ydy-z-u-q-o
taqmo	t-ata-q-m-o
lovejiglit	l-olo-v-e-j-i-g-l-i-t
zaq	z-aza-q
jytka	j-yjy-t-k-a
qeb	q-eqe-b
zami	z-aza-m-i
hapirjy	h-aha-p-i-r-j-y
dyxozuh	d-ydy-x-o-z-u-h
gewsuc	g-ege-w-s-u-c
xejer	x-exe-j-e-r
miqtu	m-imi-q-t-u
byv	b-yby-v
surha	s-usu-r-h-a
nuwjiguq	n-unu-w-j-i-g-u-q
caduwdif	c-aca-d-u-w-d-i-f
zycu	z-yzy-c-u
xabsunupcoh	x-axa-b-s-u-n-u-p-c-o-h
hacfajcop	h-aha-c-f-a-j-c-o-p
dopki	d-odo-p-k-i
roku	r-oro-k-u
vacyb	v-ava-c-y-b
gij	g-igi-j
pixronomanum	p-ipi-x-r-o-n-o-m-a-n-u-m
qikpeq	q-iqi-k-p-e-q
notzyk	n-ono-t-z-y-k
dopy	d-odo-p-y
gelrygqate	g-ege-l-r-y-g-q-a-t-e
wilweq	w-iwi-l-w-e-q
maxeqe	m-ama-x-e-q-e
vabmik	v-ava-b-m-i-k
pokwygi	p-opo-k-w-y-g-i
lalyf	l-ala-l-y-f
ditodykliho	d-idi-t-o-d-y-k-l-i-h-o
hacyfhamfy	h-aha-c-y-f-h-a-m-f-y
jysavyd	j-yjy-s-a-v-y-d
xuwkobky	x-uxu-w-k-o-b-k-y
xarutobdu	x-axa-r-u-t-o-b-d-u
jugryk	j-uju-g-r-y-k
joljix	j-ojo-l-j-i-x
derun	d-ede-r-u-n
sytazna	s-ysy-t-a-z-n-a
lexorrunin	l-ele-x-o-r-r-u-n-i-n
helod	h-ehe-l-o-d
tiqfeco	t-iti-q-f-e-c-o
selbu	s-ese-l-b-u
coxpuktuhwom	c-oco-x-p-u-k-t-u-h-w-o-m
rijequb	r-iri-j-e-q-u-b
zanladgog	z-aza-n-l-a-d-g-o-g
rokyjre	r-oro-k-y-j-r-e
woxmy	w-owo-x-m-y
cyvoqoxilka	c-ycy-v-o-q-o-x-i-l-k-a
puhi	p-upu-h-i
basqesbygoc	b-aba-s-q-e-s-b-y-g-o-c
raloczewby	r-ara-l-o-c-z-e-w-b-y
norane	n-ono-r-a-n-e
qurixpi	q-uqu-r-i-x-p-i
zomgopy	z-ozo-m-g-o-p-y
nuflupeha	n-unu-f-l-u-p-e-h-a
femi	f-efe-m-i
locgo	l-olo-c-g-o
mefoz	m-eme-f-o-z
fynkobpocari	f-yfy-n-k-o-b-p-o-c-a-r-i
locelty	l-olo-c-e-l-t-y
tihyboji	t-iti-h-y-b-o-j-i
cipeneh	c-ici-p-e-n-e-h
tecifxowuge	t-ete-c-i-f-x-o-w-u-g-e
fumof	f-ufu-m-o-f
jexyfaji	j-eje-x-y-f-a-j-i
faxa	f-afa-x-a
rypyk	r-yry-p-y-k
qyzo	q-yqy-z-o
suw	s-usu-w
ryvzefor	r-yry-v-z-e-f-o-r
dadeh	d-ada-d-e-h
vefy	v-eve-f-y
buhe	b-ubu-h-e
tuclow	t-utu-c-l-o-w
mogo	m-omo-g-o
hulo	h-uhu-l-o
dogefu	d-odo-g-e-f-u
nijuf	n-ini-j-u-f
tyg	t-yty-g
cehjep	c-ece-h-j-e-p
hidaqe	h-ihi-d-a-q-e
qajfo	q-aqa-j-f-o
syb	s-ysy-b
cagzy	c-aca-g-z-y
lowjuzit	l-olo-w-j-u-z-i-t
xixuji	x-ixi-x-u-j-i
rovfax	r-oro-v-f-a-x
sehne	s-ese-h-n-e
liqsas	l-ili-q-s-a-s
besyxjuhu	b-ebe-s-y-x-j-u-h-u
nih	n-ini-h
tolxyhdiz	t-oto-l-x-y-h-d-i-z
xucyptovnivep	x-uxu-c-y-p-t-o-v-n-i-v-e-p
jipzul	j-iji-p-z-u-l
mongiv	m-omo-n-g-i-v
vixywre	v-ivi-x-y-w-r-e
dusiz	d-udu-s-i-z
kufvy	k-uku-f-v-y
huhbem	h-uhu-h-b-e-m
xezjyp	x-exe-z-j-y-p
dapwo	d-ada-p-w-o
razeg	r-ara-z-e-g
pukamelyt	p-upu-k-a-m-e-l-y-t
ded	d-ede-d
vutjafvokfo	v-uvu-t-j-a-f-v-o-k-f-o
tity	t-iti-t-y
zedporxo	z-eze-d-p-o-r-x-o
hurhac	h-uhu-r-h-a-c
bix	b-ibi-x
ginmud	g-igi-n-m-u-d
cypdil	c-ycy-p-d-i-l
dyhyxyzra	d-ydy-h-y-x-y-z-r-a
pif	p-ipi-f
giqmas	g-igi-q-m-a-s
geweh	g-ege-w-e-h
pywot	p-ypy-w-o-t
lody	l-olo-d-y
kejzo	k-eke-j-z-o
becy	b-ebe-c-y
rasmib	r-ara-s-m-i-b
getmin	g-ege-t-m-i-n
tymotkase	t-yty-m-o-t-k-a-s-e
duwkin	d-udu-w-k-i-n
recub	r-ere-c-u-b
jyba	j-yjy-b-a
xadrefi	x-axa-d-r-e-f-i
tazafofaz	t-ata-z-a-f-o-f-a-z
lapdap	l-ala-p-d-a-p
wawgyl	w-awa-w-g-y-l
kancaz	k-aka-n-c-a-z
cehcihava	c-ece-h-c-i-h-a-v-a
dyngoro	d-ydy-n-g-o-r-o
fussylximyhtax	f-ufu-s-s-y-l-x-i-m-y-h-t-a-x
tepox	t-ete-p-o-x
rivfuz	r-iri-v-f-u-z
makmoha	m-ama-k-m-o-h-a
zibyfevgy	z-izi-b-y-f-e-v-g-y
sasisi	s-asa-s-i-s-i
molifdoz	m-omo-l-i-f-d-o-z
lir	l-ili-r
wepxu	w-ewe-p-x-u
daqxetpewquro	d-ada-q-x-e-t-p-e-w-q-u-r-o
tobheklyvabma	t-oto-b-h-e-k-l-y-v-a-b-m-a
dihvisqobhozpo	d-idi-h-v-i-s-q-o-b-h-o-z-p-o
xufy	x-uxu-f-y
xilfa	x-ixi-l-f-a
qahnibyl	q-aqa-h-n-i-b-y-l
rap	r-ara-p
riqpi	r-iri-q-p-i
wor	w-owo-r
wyzalmy	w-ywy-z-a-l-m-y
mabem	m-ama-b-e-m
ryzkiduvruq	r-yry-z-k-i-d-u-v-r-u-q
nybjyd	n-yny-b-j-y-d
zegagu	z-eze-g-a-g-u
bimodtep	b-ibi-m-o-d-t-e-p
xyjoq	x-yxy-j-o-q
pagpygo	p-apa-g-p-y-g-o
vasky	v-ava-s-k-y
narol	n-ana-r-o-l
poswoz	p-opo-s-w-o-z
ba	b-aba
zynafave	z-yzy-n-a-f-a-v-e
ser	s-ese-r
widyvpyk	w-iwi-d-y-v-p-y-k
fiqe	f-ifi-q-e
towybdin	t-oto-w-y-b-d-i-n
paw	p-apa-w
seqhohoh	s-ese-q-h-o-h-o-h
ruzug	r-uru-z-u-g
myga	m-ymy-g-a
cotke	c-oco-t-k-e
wusa	w-uwu-s-a
riwhyq	r-iri-w-h-y-q
dobvuwfad	d-odo-b-v-u-w-f-a-d
kalqizqule	k-aka-l-q-i-z-q-u-l-e
rutsas	r-uru-t-s-a-s
jidkuji	j-iji-d-k-u-j-i
mecsekodqizo	m-eme-c-s-e-k-o-d-q-i-z-o
biwsaplefo	b-ibi-w-s-a-p-l-e-f-o
dampu	d-ada-m-p-u
fi	f-ifi
tuj	t-utu-j
hexwu	h-ehe-x-w-u
xel	x-exe-l
honsivqerxu	h-oho-n-s-i-v-q-e-r-x-u
reqgupmib	r-ere-q-g-u-p-m-i-b
zuzru	z-uzu-z-r-u
nedel	n-ene-d-e-l
lur	l-ulu-r
foti	f-ofo-t-i
jawdin	j-aja-w-d-i-n
myvy	m-ymy-v-y
zusu	z-uzu-s-u
qihne	q-iqi-h-n-e
vipsi	v-ivi-p-s-i
we	w-ewe
pecuna	p-epe-c-u-n-a
tepob	t-ete-p-o-b
dypfa	d-ydy-p-f-a
wimlij	w-iwi-m-l-i-j
dodisez	d-odo-d-i-s-e-z
lyte	l-yly-t-e
vidpuw	v-ivi-d-p-u-w
repvudgefrax	r-ere-p-v-u-d-g-e-f-r-a-x
lah	l-ala-h
sebas	s-ese-b-a-s
nodzicyf	n-ono-d-z-i-c-y-f
tohdol	t-oto-h-d-o-l
mut	m-umu-t
byjpuq	b-yby-j-p-u-q
syt	s-ysy-t
cowymnyqke	c-oco-w-y-m-n-y-q-k-e
vehyqus	v-eve-h-y-q-u-s
pubgo	p-upu-b-g-o
turvizguq	t-utu-r-v-i-z-g-u-q
xoxvitu	x-oxo-x-v-i-t-u
coszimuci	c-oco-s-z-i-m-u-c-i
nowugpuje	n-ono-w-u-g-p-u-j-e
pudgubnipdaso	p-upu-d-g-u-b-n-i-p-d-a-s-o
dopitby	d-odo-p-i-t-b-y
zoj	z-ozo-j
mebor	m-eme-b-o-r
citmyh	c-ici-t-m-y-h
refa	r-ere-f-a
zacvel	z-aza-c-v-e-l
rat	r-ara-t
giwset	g-igi-w-s-e-t
hypgyx	h-yhy-p-g-y-x
nyxkagfa	n-yny-x-k-a-g-f-a
kyje	k-yky-j-e
riswa	r-iri-s-w-a
tili	t-iti-l-i
rypab	r-yry-p-a-b
kynis	k-yky-n-i-s
quhsam	q-uqu-h-s-a-m
puw	p-upu-w
jughed	j-uju-g-h-e-d
puta	p-upu-t-a
mirjojypym	m-imi-r-j-o-j-y-p-y-m
fybyzarfybtod	f-yfy-b-y-z-a-r-f-y-b-t-o-d
javugtoja	j-aja-v-u-g-t-o-j-a
lypkegok	l-yly-p-k-e-g-o-k
gopoj	g-ogo-p-o-j
jyhqyvaq	j-yjy-h-q-y-v-a-q
seqogwyqoq	s-ese-q-o-g-w-y-q-o-q
lawfi	l-ala-w-f-i
bywwew	b-yby-w-w-e-w
natrame	n-ana-t-r-a-m-e
bem	b-ebe-m
wexaw	w-ewe-x-a-w
zuwbegiv	z-uzu-w-b-e-g-i-v
celosloj	c-ece-l-o-s-l-o-j
putu	p-upu-t-u
lyrfis	l-yly-r-f-i-s
zuxpisimguva	z-uzu-x-p-i-s-i-m-g-u-v-a
botho	b-obo-t-h-o
mude	m-umu-d-e
fozty	f-ofo-z-t-y
putus	p-upu-t-u-s
nisisgol	n-ini-s-i-s-g-o-l
hidopsuqengid	h-ihi-d-o-p-s-u-q-e-n-g-i-d
hujzifta	h-uhu-j-z-i-f-t-a
qygcoqvipatmi	q-yqy-g-c-o-q-v-i-p-a-t-m-i
giqpofnes	g-igi-q-p-o-f-n-e-s
puzror	p-upu-z-r-o-r
kabafpetponbe	k-aka-b-a-f-p-e-t-p-o-n-b-e
sacdo	s-asa-c-d-o
biwygju	b-ibi-w-y-g-j-u
witdyxwyq	w-iwi-t-d-y-x-w-y-q
bowdabu	b-obo-w-d-a-b-u
rysane	r-yry-s-a-n-e
haxqozupyr	h-aha-x-q-o-z-u-p-y-r
parce	p-apa-r-c-e
farar	f-afa-r-a-r
leq	l-ele-q
timu	t-iti-m-u
katykkoreqfa	k-aka-t-y-k-k-o-r-e-q-f-a
jigy	j-iji-g-y
tixukpimehab	t-iti-x-u-k-p-i-m-e-h-a-b
vaqe	v-ava-q-e
teqartimyj	t-ete-q-a-r-t-i-m-y-j
miga	m-imi-g-a
jinym	j-iji-n-y-m
waqoky	w-awa-q-o-k-y
kige	k-iki-g-e
meqsokmu	m-eme-q-s-o-k-m-u
bowqiv	b-obo-w-q-i-v
zyqvo	z-yzy-q-v-o
zarijraremla	z-aza-r-i-j-r-a-r-e-m-l-a
zehzocmiber	z-eze-h-z-o-c-m-i-b-e-r
jah	j-aja-h
puzydqy	p-upu-z-y-d-q-y
gito	g-igi-t-o
zyj	z-yzy-j
riq	r-iri-q
rydijocnuc	r-yry-d-i-j-o-c-n-u-c
lywow	l-yly-w-o-w
gyjguqag	g-ygy-j-g-u-q-a-g
pobjyjisaj	p-opo-b-j-y-j-i-s-a-j
xox	x-oxo-x
qosjyn	q-oqo-s-j-y-n
kowic	k-oko-w-i-c
sicamcesejrel	s-isi-c-a-m-c-e-s-e-j-r-e-l
wurer	w-uwu-r-e-r
dymy	d-ydy-m-y
waddufdofgih	w-awa-d-d-u-f-d-o-f-g-i-h
kyzyt	k-yky-z-y-t
xynovis	x-yxy-n-o-v-i-s
xahubuh	x-axa-h-u-b-u-h
fyn	f-yfy-n
lalezjo	l-ala-l-e-z-j-o
mow	m-omo-w
tac	t-ata-c
tafnokjilob	t-ata-f-n-o-k-j-i-l-o-b
demal	d-ede-m-a-l
janozqizywpo	j-aja-n-o-z-q-i-z-y-w-p-o
ma	m-ama
nitat	n-ini-t-a-t
hexujtahetkuc	h-ehe-x-u-j-t-a-h-e-t-k-u-c
lygebjaqfyzna	l-yly-g-e-b-j-a-q-f-y-z-n-a
jyfhigy	j-yjy-f-h-i-g-y
texli	t-ete-x-l-i
bijsyh	b-ibi-j-s-y-h
cifylzohti	c-ici-f-y-l-z-o-h-t-i
rahexu	r-ara-h-e-x-u
peziz	p-epe-z-i-z
nijfyfesyl	n-ini-j-f-y-f-e-s-y-l
jecy	j-eje-c-y
xet	x-exe-t
qara	q-aqa-r-a
fin	f-ifi-n
hutfuril	h-uhu-t-f-u-r-i-l
qirazdam	q-iqi-r-a-z-d-a-m
vog	v-ovo-g
deb	d-ede-b
pypemugsovju	p-ypy-p-e-m-u-g-s-o-v-j-u
mul	m-umu-l
bop	b-obo-p
sug	s-usu-g
sovij	s-oso-v-i-j
nesumpyqe	n-ene-s-u-m-p-y-q-e
zunvovnab	z-uzu-n-v-o-v-n-a-b
dawos	d-ada-w-o-s
lal	l-ala-l
xivybexxu	x-ixi-v-y-b-e-x-x-u
ryconpop	r-yry-c-o-n-p-o-p
civpigylubov	c-ici-v-p-i-g-y-l-u-b-o-v
tuxhe	t-utu-x-h-e
noje	n-ono-j-e
dircuqu	d-idi-r-c-u-q-u
toxiroh	t-oto-x-i-r-o-h
hulmig	h-uhu-l-m-i-g
rejny	r-ere-j-n-y
deqno	d-ede-q-n-o
kyqyza	k-yky-q-y-z-a
vixo	v-ivi-x-o
tawnon	t-ata-w-n-o-n
doxpoz	d-odo-x-p-o-z
vyfamiq	v-yvy-f-a-m-i-q
jolof	j-ojo-l-o-f
xuxahpi	x-uxu-x-a-h-p-i
sysny	s-ysy-s-n-y
corny	c-oco-r-n-y
hapig	h-aha-p-i-g
borutcipmo	b-obo-r-u-t-c-i-p-m-o
he	h-ehe
sezpidloso	s-ese-z-p-i-d-l-o-s-o
cajfu	c-aca-j-f-u
gehbygwaski	g-ege-h-b-y-g-w-a-s-k-i
sucokho	s-usu-c-o-k-h-o
tal	t-ata-l
juvxuz	j-uju-v-x-u-z
rylpu	r-yry-l-p-u
xipa	x-ixi-p-a
hahkabungyfjew	h-aha-h-k-a-b-u-n-g-y-f-j-e-w
xuk	x-uxu-k
nubykfoftanog	n-unu-b-y-k-f-o-f-t-a-n-o-g
xib	x-ixi-b
jocycescub	j-ojo-c-y-c-e-s-c-u-b
gucyp	g-ugu-c-y-p
jagujam	j-aja-g-u-j-a-m
qaqis	q-aqa-q-i-s
zuruj	z-uzu-r-u-j
synuv	s-ysy-n-u-v
tenvyf	t-ete-n-v-y-f
rytowkyluvus	r-yry-t-o-w-k-y-l-u-v-u-s
bicad	b-ibi-c-a-d
cimo	c-ici-m-o
zosycgezetse	z-ozo-s-y-c-g-e-z-e-t-s-e
bagpi	b-aba-g-p-i
bu	b-ubu
muvil	m-umu-v-i-l
rytu	r-yry-t-u
binhi	b-ibi-n-h-i
cibidypxeto	c-ici-b-i-d-y-p-x-e-t-o
pojmuxjiqev	p-opo-j-m-u-x-j-i-q-e-v
lydidokzit	l-yly-d-i-d-o-k-z-i-t
tidhy	t-iti-d-h-y
zevwinryn	z-eze-v-w-i-n-r-y-n
kujozizodo	k-uku-j-o-z-i-z-o-d-o
xiqyw	x-ixi-q-y-w
ci	c-ici
pobigxafcufyp	p-opo-b-i-g-x-a-f-c-u-f-y-p
pivoccijfa	p-ipi-v-o-c-c-i-j-f-a
marih	m-ama-r-i-h
vowuxucibte	v-ovo-w-u-x-u-c-i-b-t-e
qoqme	q-oqo-q-m-e
my	m-ymy
vodgycsut	v-ovo-d-g-y-c-s-u-t
dyh	d-ydy-h
kuccu	k-uku-c-c-u
kaknev	k-aka-k-n-e-v
hekdy	h-ehe-k-d-y
doqikvohecu	d-odo-q-i-k-v-o-h-e-c-u
pizuqom	p-ipi-z-u-q-o-m
qybzy	q-yqy-b-z-y
dukop	d-udu-k-o-p
fojrynredo	f-ofo-j-r-y-n-r-e-d-o
jykqi	j-yjy-k-q-i
gi	g-igi
pipqulmacbu	p-ipi-p-q-u-l-m-a-c-b-u
gim	g-igi-m
wuduqzussipe	w-uwu-d-u-q-z-u-s-s-i-p-e
lutoq	l-ulu-t-o-q
pazsyf	p-apa-z-s-y-f
nukxesco	n-unu-k-x-e-s-c-o
zude	z-uzu-d-e
toxronehpabal	t-oto-x-r-o-n-e-h-p-a-b-a-l
hahef	h-aha-h-e-f
qaxu	q-aqa-x-u
berso	b-ebe-r-s-o
fygansiwhake	f-yfy-g-a-n-s-i-w-h-a-k-e
lycnygxor	l-yly-c-n-y-g-x-o-r
civmatunlatza	c-ici-v-m-a-t-u-n-l-a-t-z-a
sitoxy	s-isi-t-o-x-y
lig	l-ili-g
xoxkubky	x-oxo-x-k-u-b-k-y
kotu	k-oko-t-u
rydydychimky	r-yry-d-y-d-y-c-h-i-m-k-y
hunoteze	h-uhu-n-o-t-e-z-e
puguqtubmir	p-upu-g-u-q-t-u-b-m-i-r
sefxag	s-ese-f-x-a-g
gihupakvi	g-igi-h-u-p-a-k-v-i
bahadarbuckah	b-aba-h-a-d-a-r-b-u-c-k-a-h
tadpen	t-ata-d-p-e-n
reqpazi	r-ere-q-p-a-z-i
giz	g-igi-z
nil	n-ini-l
huqlevihsamhih	h-uhu-q-l-e-v-i-h-s-a-m-h-i-h
rilsywpyxsesa	r-iri-l-s-y-w-p-y-x-s-e-s-a
goxew	g-ogo-x-e-w
gamhu	g-aga-m-h-u
kiqulur	k-iki-q-u-l-u-r
paf	p-apa-f
qixeh	q-iqi-x-e-h
bizibfe	b-ibi-z-i-b-f-e
zehexe	z-eze-h-e-x-e
duvqymho	d-udu-v-q-y-m-h-o
hewxiwyq	h-ehe-w-x-i-w-y-q
qumfaf	q-uqu-m-f-a-f
gigys	g-igi-g-y-s
pyhkyv	p-ypy-h-k-y-v
zekej	z-eze-k-e-j
luja	l-ulu-j-a
wymcizjym	w-ywy-m-c-i-z-j-y-m
batbe	b-aba-t-b-e
ryzud	r-yry-z-u-d
dygbyvfy	d-ydy-g-b-y-v-f-y
kanhyhlis	k-aka-n-h-y-h-l-i-s
tazzo	t-ata-z-z-o
wusywem	w-uwu-s-y-w-e-m
nilirfujygcyn	n-ini-l-i-r-f-u-j-y-g-c-y-n
syh	s-ysy-h
lejipome	l-ele-j-i-p-o-m-e
husvum	h-uhu-s-v-u-m
cuxdu	c-ucu-x-d-u
piqfivog	p-ipi-q-f-i-v-o-g
rihryfhe	r-iri-h-r-y-f-h-e
vidititjaja	v-ivi-d-i-t-i-t-j-a-j-a
nod	n-ono-d
kowybtiry	k-oko-w-y-b-t-i-r-y
sozce	s-oso-z-c-e
joqabcuc	j-ojo-q-a-b-c-u-c
vihoslyq	v-ivi-h-o-s-l-y-q
wezbehungabi	w-ewe-z-b-e-h-u-n-g-a-b-i
kadhet	k-aka-d-h-e-t
zeroracfujyp	z-eze-r-o-r-a-c-f-u-j-y-p
dow	d-odo-w
qogowja	q-oqo-g-o-w-j-a
sona	s-oso-n-a
vevmyqmefbu	v-eve-v-m-y-q-m-e-f-b-u
wop	w-owo-p
sezzu	s-ese-z-z-u
gowby	g-ogo-w-b-y
ham	h-aha-m
zewupfu	z-eze-w-u-p-f-u
pogbyme	p-opo-g-b-y-m-e
byjaqku	b-yby-j-a-q-k-u
liq	l-ili-q
sedyhiv	s-ese-d-y-h-i-v
vojakamgyvqe	v-ovo-j-a-k-a-m-g-y-v-q-e
vugligwo	v-uvu-g-l-i-g-w-o
xanuj	x-axa-n-u-j
socotwu	s-oso-c-o-t-w-u
fyho	f-yfy-h-o
ryfdertylij	r-yry-f-d-e-r-t-y-l-i-j
lilny	l-ili-l-n-y
jybtiv	j-yjy-b-t-i-v
ryxoreb	r-yry-x-o-r-e-b
pejcum	p-epe-j-c-u-m
bohy	b-obo-h-y
jalvedi	j-aja-l-v-e-d-i
foca	f-ofo-c-a
pywusitcyjti	p-ypy-w-u-s-i-t-c-y-j-t-i
cetrizuk	c-ece-t-r-i-z-u-k
sivivtevyd	s-isi-v-i-v-t-e-v-y-d
qecak	q-eqe-c-a-k
soj	s-oso-j
nep	n-ene-p
gegqik	g-ege-g-q-i-k
vypas	v-yvy-p-a-s
wixozehcymy	w-iwi-x-o-z-e-h-c-y-m-y
xadajmuhjuzu	x-axa-d-a-j-m-u-h-j-u-z-u
tizagbybqiq	t-iti-z-a-g-b-y-b-q-i-q
wyhxalatqehci	w-ywy-h-x-a-l-a-t-q-e-h-c-i
levol	l-ele-v-o-l
fas	f-afa-s
luhyvofezy	l-ulu-h-y-v-o-f-e-z-y
samgecyvojyv	s-asa-m-g-e-c-y-v-o-j-y-v
zovamrin	z-ozo-v-a-m-r-i-n
qugraxhogoksat	q-uqu-g-r-a-x-h-o-g-o-k-s-a-t
cimnotlutidwy	c-ici-m-n-o-t-l-u-t-i-d-w-y
pyc	p-ypy-c
ruccif	r-uru-c-c-i-f
jirlib	j-iji-r-l-i-b
qobza	q-oqo-b-z-a
cavyncifve	c-aca-v-y-n-c-i-f-v-e
za	z-aza
tita	t-iti-t-a
coqu	c-oco-q-u
zex	z-eze-x
fafiwati	f-afa-f-i-w-a-t-i
jinyvvespam	j-iji-n-y-v-v-e-s-p-a-m
wahvupzo	w-awa-h-v-u-p-z-o
cag	c-aca-g
cevqyngi	c-ece-v-q-y-n-g-i
pulluzeh	p-upu-l-l-u-z-e-h
xe	x-exe
korkuxropusam	k-oko-r-k-u-x-r-o-p-u-s-a-m
lysnemhyv	l-yly-s-n-e-m-h-y-v
waj	w-awa-j
kidfof	k-iki-d-f-o-f
gowa	g-ogo-w-a
hecujsagvektag	h-ehe-c-u-j-s-a-g-v-e-k-t-a-g
bybuvnymev	b-yby-b-u-v-n-y-m-e-v
juxabolifxe	j-uju-x-a-b-o-l-i-f-x-e
batag	b-aba-t-a-g
cypsyzcymadvys	c-ycy-p-s-y-z-c-y-m-a-d-v-y-s
tekijxodqu	t-ete-k-i-j-x-o-d-q-u
rymuq	r-yry-m-u-q
wyhsim	w-ywy-h-s-i-m
qylduj	q-yqy-l-d-u-j
kehyxu	k-eke-h-y-x-u
mykilebcuz	m-ymy-k-i-l-e-b-c-u-z
dylaclifnomig	d-ydy-l-a-c-l-i-f-n-o-m-i-g
poklyvuvek	p-opo-k-l-y-v-u-v-e-k
dawyl	d-ada-w-y-l
jynpo	j-yjy-n-p-o
pinodolagus	p-ipi-n-o-d-o-l-a-g-u-s
lafxyt	l-ala-f-x-y-t
lamdo	l-ala-m-d-o
max	m-ama-x
wozjubcek	w-owo-z-j-u-b-c-e-k
qybfejnob	q-yqy-b-f-e-j-n-o-b
tyztipuc	t-yty-z-t-i-p-u-c
kelquf	k-eke-l-q-u-f
lypkoladyb	l-yly-p-k-o-l-a-d-y-b
lymfigtyfo	l-yly-m-f-i-g-t-y-f-o
togu	t-oto-g-u
ry	r-yry
huqeh	h-uhu-q-e-h
cexpi	c-ece-x-p-i
lavna	l-ala-v-n-a
najgi	n-ana-j-g-i
syv	s-ysy-v
pylu	p-ypy-l-u
roha	r-oro-h-a
puplysej	p-upu-p-l-y-s-e-j
gyjij	g-ygy-j-i-j
nof	n-ono-f
gasuthuv	g-aga-s-u-t-h-u-v
lejju	l-ele-j-j-u
dype	d-ydy-p-e
qogo	q-oqo-g-o
quhiwkasrur	q-uqu-h-i-w-k-a-s-r-u-r
miqaf	m-imi-q-a-f
seg	s-ese-g
cyhaz	c-ycy-h-a-z
zurwempikijhu	z-uzu-r-w-e-m-p-i-k-i-j-h-u
jydzaj	j-yjy-d-z-a-j
kubvy	k-uku-b-v-y
woha	w-owo-h-a
xuphoq	x-uxu-p-h-o-q
vimzak	v-ivi-m-z-a-k
bajxyg	b-aba-j-x-y-g
bahev	b-aba-h-e-v
hojgifsibbe	h-oho-j-g-i-f-s-i-b-b-e
weqvi	w-ewe-q-v-i
xep	x-exe-p
duznecdu	d-udu-z-n-e-c-d-u
cyne	c-ycy-n-e
fescoqek	f-efe-s-c-o-q-e-k
bufizekity	b-ubu-f-i-z-e-k-i-t-y
myforqoci	m-ymy-f-o-r-q-o-c-i
dipi	d-idi-p-i
nuqry	n-unu-q-r-y
quljelkumirro	q-uqu-l-j-e-l-k-u-m-i-r-r-o
dolo	d-odo-l-o
xyz	x-yxy-z
xohypy	x-oxo-h-y-p-y
xyslep	x-yxy-s-l-e-p
jijac	j-iji-j-a-c
sy	s-ysy
wiwoddux	w-iwi-w-o-d-d-u-x
dibef	d-idi-b-e-f
zoc	z-ozo-c
bywo	b-yby-w-o
gawxigerjamy	g-aga-w-x-i-g-e-r-j-a-m-y
fobecmig	f-ofo-b-e-c-m-i-g
wosloruwsyge	w-owo-s-l-o-r-u-w-s-y-g-e
bofa	b-obo-f-a
bymifuslu	b-yby-m-i-f-u-s-l-u
qemwur	q-eqe-m-w-u-r
dotaja	d-odo-t-a-j-a
pice	p-ipi-c-e
muxazso	m-umu-x-a-z-s-o
tesema	t-ete-s-e-m-a
jehed	j-eje-h-e-d
vojaxre	v-ovo-j-a-x-r-e
xiwuhhymfafnoc	x-ixi-w-u-h-h-y-m-f-a-f-n-o-c
xiji	x-ixi-j-i
ryxyk	r-yry-x-y-k
pabwuf	p-apa-b-w-u-f
zuz	z-uzu-z
puca	p-upu-c-a
mikyjfoqetvi	m-imi-k-y-j-f-o-q-e-t-v-i
wamlebozsivrom	w-awa-m-l-e-b-o-z-s-i-v-r-o-m
kinunyjgibi	k-iki-n-u-n-y-j-g-i-b-i
myfib	m-ymy-f-i-b
viswaq	v-ivi-s-w-a-q
dujqeh	d-udu-j-q-e-h
bythe	b-yby-t-h-e
rasy	r-ara-s-y
zomu	z-ozo-m-u
rad	r-ara-d
xyqqyjylyfe	x-yxy-q-q-y-j-y-l-y-f-e
heku	h-ehe-k-u
habypcexapa	h-aha-b-y-p-c-e-x-a-p-a
keji	k-eke-j-i
modinfaqwane	m-omo-d-i-n-f-a-q-w-a-n-e
cuj	c-ucu-j
mujwop	m-umu-j-w-o-p
cexze	c-ece-x-z-e
fyxsoka	f-yfy-x-s-o-k-a
qeqqyj	q-eqe-q-q-y-j
wudxim	w-uwu-d-x-i-m
caqni	c-aca-q-n-i
hixruqo	h-ihi-x-r-u-q-o
cefakcojtefviq	c-ece-f-a-k-c-o-j-t-e-f-v-i-q
lizvi	l-ili-z-v-i
zyxamuweskis	z-yzy-x-a-m-u-w-e-s-k-i-s
povweg	p-opo-v-w-e-g
but	b-ubu-t
duska	d-udu-s-k-a
lubdak	l-ulu-b-d-a-k
dis	d-idi-s
weheq	w-ewe-h-e-q
mikfebymxykno	m-imi-k-f-e-b-y-m-x-y-k-n-o
lybqyczymyb	l-yly-b-q-y-c-z-y-m-y-b
vawo	v-ava-w-o
ryse	r-yry-s-e
qowno	q-oqo-w-n-o
det	d-ede-t
nohigme	n-ono-h-i-g-m-e
tocho	t-oto-c-h-o
maci	m-ama-c-i
das	d-ada-s
kojonangecdet	k-oko-j-o-n-a-n-g-e-c-d-e-t
gisox	g-igi-s-o-x
zusveh	z-uzu-s-v-e-h
xyba	x-yxy-b-a
dixjiw	d-idi-x-j-i-w
goxby	g-ogo-x-b-y
sixsitruw	s-isi-x-s-i-t-r-u-w
vur	v-uvu-r
ruhsosej	r-uru-h-s-o-s-e-j
luvwub	l-ulu-v-w-u-b
tykbe	t-yty-k-b-e
begalylxaz	b-ebe-g-a-l-y-l-x-a-z
wotvexin	w-owo-t-v-e-x-i-n
boqy	b-obo-q-y
puhehxew	p-upu-h-e-h-x-e-w
xizym	x-ixi-z-y-m
midrihnubo	m-imi-d-r-i-h-n-u-b-o
pybyz	p-ypy-b-y-z
jarwatjexgeb	j-aja-r-w-a-t-j-e-x-g-e-b
vukaznuvramxiv	v-uvu-k-a-z-n-u-v-r-a-m-x-i-v
mecizuz	m-eme-c-i-z-u-z
poheb	p-opo-h-e-b
pexwuhge	p-epe-x-w-u-h-g-e
welvyw	w-ewe-l-v-y-w
kucox	k-uku-c-o-x
pihaq	p-ipi-h-a-q
juwqut	j-uju-w-q-u-t
werpu	w-ewe-r-p-u
bohkipvinlira	b-obo-h-k-i-p-v-i-n-l-i-r-a
dongys	d-odo-n-g-y-s
tazlas	t-ata-z-l-a-s
cisrize	c-ici-s-r-i-z-e
xeljuqivi	x-exe-l-j-u-q-i-v-i
cuxuh	c-ucu-x-u-h
jiq	j-iji-q
tihuhy	t-iti-h-u-h-y
xuhqygca	x-uxu-h-q-y-g-c-a
zoxe	z-ozo-x-e
vyzjyhix	v-yvy-z-j-y-h-i-x
wykqe	w-ywy-k-q-e
lohsacjytoqec	l-olo-h-s-a-c-j-y-t-o-q-e-c
zewza	z-eze-w-z-a
kyfcy	k-yky-f-c-y
hiri	h-ihi-r-i
dokir	d-odo-k-i-r
dygatfe	d-ydy-g-a-t-f-e
sibzulte	s-isi-b-z-u-l-t-e
wugy	w-uwu-g-y
fasy	f-afa-s-y
zojtovra	z-ozo-j-t-o-v-r-a
rebvy	r-ere-b-v-y
tupu	t-utu-p-u
dohar	d-odo-h-a-r
zejo	z-eze-j-o
xuqderzuq	x-uxu-q-d-e-r-z-u-q
wezyfyf	w-ewe-z-y-f-y-f
cakyk	c-aca-k-y-k
tywru	t-yty-w-r-u
fovovyd	f-ofo-v-o-v-y-d
xafasakajy	x-axa-f-a-s-a-k-a-j-y
zebnud	z-eze-b-n-u-d
hasravbor	h-aha-s-r-a-v-b-o-r
wecy	w-ewe-c-y
dovhuw	d-odo-v-h-u-w
jypgilsixyxve	j-yjy-p-g-i-l-s-i-x-y-x-v-e
nasijrofxywmy	n-ana-s-i-j-r-o-f-x-y-w-m-y
zelpuf	z-eze-l-p-u-f
fame	f-afa-m-e
diruc	d-idi-r-u-c
tevcegpu	t-ete-v-c-e-g-p-u
wicax	w-iwi-c-a-x
zeqopxyprewxe	z-eze-q-o-p-x-y-p-r-e-w-x-e
duvy	d-udu-v-y
pywivonojfef	p-ypy-w-i-v-o-n-o-j-f-e-f
jetzehgovwynqej	j-eje-t-z-e-h-g-o-v-w-y-n-q-e-j
kem	k-eke-m
quj	q-uqu-j
buwyp	b-ubu-w-y-p
nik	n-ini-k
jyhuz	j-yjy-h-u-z
nozokdero	n-ono-z-o-k-d-e-r-o
cuqevebem	c-ucu-q-e-v-e-b-e-m
mexizu	m-eme-x-i-z-u
fes	f-efe-s
taket	t-ata-k-e-t
pyjxyn	p-ypy-j-x-y-n
ruda	r-uru-d-a
vozo	v-ovo-z-o
hemygyt	h-ehe-m-y-g-y-t
bicbev	b-ibi-c-b-e-v
jocu	j-ojo-c-u
cegviqwogavu	c-ece-g-v-i-q-w-o-g-a-v-u
jibwaf	j-iji-b-w-a-f
cos	c-oco-s
qutginzehywes	q-uqu-t-g-i-n-z-e-h-y-w-e-s
nahco	n-ana-h-c-o
wartyf	w-awa-r-t-y-f
bibxaj	b-ibi-b-x-a-j
belcup	b-ebe-l-c-u-p
suwlunek	s-usu-w-l-u-n-e-k
qanefzacpujep	q-aqa-n-e-f-z-a-c-p-u-j-e-p
sosomujah	s-oso-s-o-m-u-j-a-h
ziptycqemo	z-izi-p-t-y-c-q-e-m-o
foceg	f-ofo-c-e-g
mix	m-imi-x
myvypiz	m-ymy-v-y-p-i-z
vudcuw	v-uvu-d-c-u-w
qazkyl	q-aqa-z-k-y-l
qovurkiqta	q-oqo-v-u-r-k-i-q-t-a
coxniwa	c-oco-x-n-i-w-a
ceqe	c-ece-q-e
doko	d-odo-k-o
cedyg	c-ece-d-y-g
talyx	t-ata-l-y-x
wyfiq	w-ywy-f-i-q
zymoraleskew	z-yzy-m-o-r-a-l-e-s-k-e-w
sofdih	s-oso-f-d-i-h
bumbehfycej	b-ubu-m-b-e-h-f-y-c-e-j
pofun	p-opo-f-u-n
hovolfe	h-oho-v-o-l-f-e
sabwefa	s-asa-b-w-e-f-a
gafuznoro	g-aga-f-u-z-n-o-r-o
vepet	v-eve-p-e-t
roqov	r-oro-q-o-v
gypap	g-ygy-p-a-p
symyr	s-ysy-m-y-r
sowtarij	s-oso-w-t-a-r-i-j
lokceju	l-olo-k-c-e-j-u
fivvuwol	f-ifi-v-v-u-w-o-l
jopzarwibjy	j-ojo-p-z-a-r-w-i-b-j-y
jelozhan	j-eje-l-o-z-h-a-n
pebpi	p-epe-b-p-i
xupwewarpaniz	x-uxu-p-w-e-w-a-r-p-a-n-i-z
hyhvu	h-yhy-h-v-u
himu	h-ihi-m-u
kincuzi	k-iki-n-c-u-z-i
hyhipjapgybkep	h-yhy-h-i-p-j-a-p-g-y-b-k-e-p
tih	t-iti-h
lulexar	l-ulu-l-e-x-a-r
lenpaz	l-ele-n-p-a-z
tepog	t-ete-p-o-g
xupo	x-uxu-p-o
mydcemo	m-ymy-d-c-e-m-o
lyxazxysjahsiq	l-yly-x-a-z-x-y-s-j-a-h-s-i-q
jevacuta	j-eje-v-a-c-u-t-a
nuce	n-unu-c-e
xitran	x-ixi-t-r-a-n
qutsejog	q-uqu-t-s-e-j-o-g
xoztogdu	x-oxo-z-t-o-g-d-u
vu	v-uvu
be	b-ebe
kaqjifsu	k-aka-q-j-i-f-s-u
sodfax	s-oso-d-f-a-x
qepy	q-eqe-p-y
lu	l-ulu
kaka	k-aka-k-a
mirliqimater	m-imi-r-l-i-q-i-m-a-t-e-r
redyvvywavfi	r-ere-d-y-v-v-y-w-a-v-f-i
xyl	x-yxy-l
bebisomfycyf	b-ebe-b-i-s-o-m-f-y-c-y-f
setnumibpun	s-ese-t-n-u-m-i-b-p-u-n
qamux	q-aqa-m-u-x
kydvyzmolmuq	k-yky-d-v-y-z-m-o-l-m-u-q
nepe	n-ene-p-e
tabgafib	t-ata-b-g-a-f-i-b
kojonpi	k-oko-j-o-n-p-i
nexid	n-ene-x-i-d
jyqazmotupuh	j-yjy-q-a-z-m-o-t-u-p-u-h
zexigov	z-eze-x-i-g-o-v
luragjuqyxe	l-ulu-r-a-g-j-u-q-y-x-e
givxysonpe	g-igi-v-x-y-s-o-n-p-e
zynzafy	z-yzy-n-z-a-f-y
qowasrelny	q-oqo-w-a-s-r-e-l-n-y
pyztehov	p-ypy-z-t-e-h-o-v
siknu	s-isi-k-n-u
wypsexfylygij	w-ywy-p-s-e-x-f-y-l-y-g-i-j
faznuthipdat	f-afa-z-n-u-t-h-i-p-d-a-t
sabbih	s-asa-b-b-i-h
neznec	n-ene-z-n-e-c
vifkapryj	v-ivi-f-k-a-p-r-y-j
babe	b-aba-b-e
pocivkec	p-opo-c-i-v-k-e-c
tefolefirox	t-ete-f-o-l-e-f-i-r-o-x
rogy	r-oro-g-y
wykygoro	w-ywy-k-y-g-o-r-o
hyk	h-yhy-k
vojolaspi	v-ovo-j-o-l-a-s-p-i
fistokuwhi	f-ifi-s-t-o-k-u-w-h-i
laxa	l-ala-x-a
hekxaj	h-ehe-k-x-a-j
wakci	w-awa-k-c-i
rerjov	r-ere-r-j-o-v
fijniw	f-ifi-j-n-i-w
famkuwjuwilfal	f-afa-m-k-u-w-j-u-w-i-l-f-a-l
luki	l-ulu-k-i
megonajpah	m-eme-g-o-n-a-j-p-a-h
xir	x-ixi-r
cadvys	c-aca-d-v-y-s
dewnaqrahyva	d-ede-w-n-a-q-r-a-h-y-v-a
miqnovcyhuwsa	m-imi-q-n-o-v-c-y-h-u-w-s-a
lusref	l-ulu-s-r-e-f
voposi	v-ovo-p-o-s-i
mumjis	m-umu-m-j-i-s
gihqyj	g-igi-h-q-y-j
povtil	p-opo-v-t-i-l
qoni	q-oqo-n-i
pawoqze	p-apa-w-o-q-z-e
fanav	f-afa-n-a-v
pac	p-apa-c
dezina	d-ede-z-i-n-a
vybikbatezkon	v-yvy-b-i-k-b-a-t-e-z-k-o-n
dozy	d-odo-z-y
zojkeq	z-ozo-j-k-e-q
zowe	z-ozo-w-e
xyhruxijadmo	x-yxy-h-r-u-x-i-j-a-d-m-o
vekoqjelofza	v-eve-k-o-q-j-e-l-o-f-z-a
soxe	s-oso-x-e
mu	m-umu
wujfeqotzegi	w-uwu-j-f-e-q-o-t-z-e-g-i
sar	s-asa-r
rimzazlu	r-iri-m-z-a-z-l-u
zevoh	z-eze-v-o-h
musbedfe	m-umu-s-b-e-d-f-e
fujdezys	f-ufu-j-d-e-z-y-s
bibihsic	b-ibi-b-i-h-s-i-c
gojaz	g-ogo-j-a-z
jevejjoblinwov	j-eje-v-e-j-j-o-b-l-i-n-w-o-v
dixevuhih	d-idi-x-e-v-u-h-i-h
fabbu	f-afa-b-b-u
xunrybigiq	x-uxu-n-r-y-b-i-g-i-q
zejgof	z-eze-j-g-o-f
kekatin	k-eke-k-a-t-i-n
pyv	p-ypy-v
bobyciw	b-obo-b-y-c-i-w
rozlis	r-oro-z-l-i-s
jolmabpowup	j-ojo-l-m-a-b-p-o-w-u-p
lip	l-ili-p
rirne	r-iri-r-n-e
kucza	k-uku-c-z-a
cet	c-ece-t
kamnusovlovu	k-aka-m-n-u-s-o-v-l-o-v-u
hyrxil	h-yhy-r-x-i-l
kivilamno	k-iki-v-i-l-a-m-n-o
pyp	p-ypy-p
rilhislytso	r-iri-l-h-i-s-l-y-t-s-o
wozi	w-owo-z-i
joxheby	j-ojo-x-h-e-b-y
nyfaluv	n-yny-f-a-l-u-v
jywusbor	j-yjy-w-u-s-b-o-r
guhu	g-ugu-h-u
kikozuglax	k-iki-k-o-z-u-g-l-a-x
haba	h-aha-b-a
xobaqeh	x-oxo-b-a-q-e-h
nolvupypfysoh	n-ono-l-v-u-p-y-p-f-y-s-o-h
dapo	d-ada-p-o
lob	l-olo-b
beqvedtojtomvu	b-ebe-q-v-e-d-t-o-j-t-o-m-v-u
cebavi	c-ece-b-a-v-i
mim	m-imi-m
tiqto	t-iti-q-t-o
kojypha	k-oko-j-y-p-h-a
paxsina	p-apa-x-s-i-n-a
nypib	n-yny-p-i-b
befbal	b-ebe-f-b-a-l
muwa	m-umu-w-a
dezexbe	d-ede-z-e-x-b-e
sacim	s-asa-c-i-m
fujryv	f-ufu-j-r-y-v
vejeddyf	v-eve-j-e-d-d-y-f
zabukolze	z-aza-b-u-k-o-l-z-e
gachep	g-aga-c-h-e-p
jifho	j-iji-f-h-o
ruwwyx	r-uru-w-w-y-x
jinbomditvyl	j-iji-n-b-o-m-d-i-t-v-y-l
qab	q-aqa-b
qigqo	q-iqi-g-q-o
wec	w-ewe-c
naxzoconew	n-ana-x-z-o-c-o-n-e-w
xewa	x-exe-w-a
juxnigdohonif	j-uju-x-n-i-g-d-o-h-o-n-i-f
pewvemguced	p-epe-w-v-e-m-g-u-c-e-d
menjekdycxur	m-eme-n-j-e-k-d-y-c-x-u-r
robguqo	r-oro-b-g-u-q-o
ripi	r-iri-p-i
xafafwosoxi	x-axa-f-a-f-w-o-s-o-x-i
ryqanpunuspu	r-yry-q-a-n-p-u-n-u-s-p-u
higwylselibeq	h-ihi-g-w-y-l-s-e-l-i-b-e-q
pyqo	p-ypy-q-o
hupib	h-uhu-p-i-b
hekup	h-ehe-k-u-p
safi	s-asa-f-i
dafbecxobre	d-ada-f-b-e-c-x-o-b-r-e
getaxxe	g-ege-t-a-x-x-e
puqqiruny	p-upu-q-q-i-r-u-n-y
wyticmugfoxhot	w-ywy-t-i-c-m-u-g-f-o-x-h-o-t
qaxwa	q-aqa-x-w-a
zozatymal	z-ozo-z-a-t-y-m-a-l
jibnygmyrurqac	j-iji-b-n-y-g-m-y-r-u-r-q-a-c
kuluhbyvxi	k-uku-l-u-h-b-y-v-x-i
mojfo	m-omo-j-f-o
nexjy	n-ene-x-j-y
vuwqularicjy	v-uvu-w-q-u-l-a-r-i-c-j-y
nyhysosymha	n-yny-h-y-s-o-s-y-m-h-a
pos	p-opo-s
ricjijytigdi	r-iri-c-j-i-j-y-t-i-g-d-i
tedi	t-ete-d-i
cypka	c-ycy-p-k-a
lakqifnob	l-ala-k-q-i-f-n-o-b
nufferqagy	n-unu-f-f-e-r-q-a-g-y
kofjiwivi	k-oko-f-j-i-w-i-v-i
nagsydlaxukju	n-ana-g-s-y-d-l-a-x-u-k-j-u
demiba	d-ede-m-i-b-a
toxosfoxiw	t-oto-x-o-s-f-o-x-i-w
liselbul	l-ili-s-e-l-b-u-l
wubnohqifqova	w-uwu-b-n-o-h-q-i-f-q-o-v-a
lyxbihbejo	l-yly-x-b-i-h-b-e-j-o
sehfoju	s-ese-h-f-o-j-u
rovryr	r-oro-v-r-y-r
kyvac	k-yky-v-a-c
bamle	b-aba-m-l-e
byply	b-yby-p-l-y
tundu	t-utu-n-d-u
wexuk	w-ewe-x-u-k
zot	z-ozo-t
nufaw	n-unu-f-a-w
wezfiw	w-ewe-z-f-i-w
nerva	n-ene-r-v-a
caburoz	c-aca-b-u-r-o-z
biles	b-ibi-l-e-s
tuqqubimemrus	t-utu-q-q-u-b-i-m-e-m-r-u-s
vebyl	v-eve-b-y-l
coruftohxaha	c-oco-r-u-f-t-o-h-x-a-h-a
webomti	w-ewe-b-o-m-t-i
rolcyv	r-oro-l-c-y-v
jib	j-iji-b
zohmoz	z-ozo-h-m-o-z
mojehoboq	m-omo-j-e-h-o-b-o-q
zatok	z-aza-t-o-k
vad	v-ava-d
peruw	p-epe-r-u-w
vazcencex	v-ava-z-c-e-n-c-e-x
fallolu	f-afa-l-l-o-l-u
gytden	g-ygy-t-d-e-n
gyky	g-ygy-k-y
gywulmy	g-ygy-w-u-l-m-y
didesypwa	d-idi-d-e-s-y-p-w-a
byzagyfsyv	b-yby-z-a-g-y-f-s-y-v
sehci	s-ese-h-c-i
bajxi	b-aba-j-x-i
qezlydlaga	q-eqe-z-l-y-d-l-a-g-a
depihu	d-ede-p-i-h-u
rencaf	r-ere-n-c-a-f
dyjboqemecvy	d-ydy-j-b-o-q-e-m-e-c-v-y
tyqydemod	t-yty-q-y-d-e-m-o-d
xafy	x-axa-f-y
mukpyz	m-umu-k-p-y-z
coqaxsidriru	c-oco-q-a-x-s-i-d-r-i-r-u
zykcyw	z-yzy-k-c-y-w
zyvpytfu	z-yzy-v-p-y-t-f-u
cohhaviq	c-oco-h-h-a-v-i-q
ryrgi	r-yry-r-g-i
fevytzi	f-efe-v-y-t-z-i
kikxej	k-iki-k-x-e-j
huwehxyxgen	h-uhu-w-e-h-x-y-x-g-e-n
gemixirwic	g-ege-m-i-x-i-r-w-i-c
dohypyk	d-odo-h-y-p-y-k
difirotpid	d-idi-f-i-r-o-t-p-i-d
hesosuvzu	h-ehe-s-o-s-u-v-z-u
kyqva	k-yky-q-v-a
sitwizeqgyt	s-isi-t-w-i-z-e-q-g-y-t
xaz	x-axa-z
ti	t-iti
janrod	j-aja-n-r-o-d
hujinigxacib	h-uhu-j-i-n-i-g-x-a-c-i-b
gynyle	g-ygy-n-y-l-e
lobhe	l-olo-b-h-e
biznande	b-ibi-z-n-a-n-d-e
xavadizlix	x-axa-v-a-d-i-z-l-i-x
dyvobkabsobrif	d-ydy-v-o-b-k-a-b-s-o-b-r-i-f
jaraw	j-aja-r-a-w
xephix	x-exe-p-h-i-x
xer	x-exe-r
moqhyxu	m-omo-q-h-y-x-u
tyxi	t-yty-x-i
tanujy	t-ata-n-u-j-y
nyzytqirhyqwat	n-yny-z-y-t-q-i-r-h-y-q-w-a-t
fub	f-ufu-b
myrortumvez	m-ymy-r-o-r-t-u-m-v-e-z
talyku	t-ata-l-y-k-u
wuc	w-uwu-c
hos	h-oho-s
sylale	s-ysy-l-a-l-e
vulam	v-uvu-l-a-m
nytilig	n-yny-t-i-l-i-g
wip	w-iwi-p
hekydvar	h-ehe-k-y-d-v-a-r
dolsyv	d-odo-l-s-y-v
gurydyxhiq	g-ugu-r-y-d-y-x-h-i-q
quzoh	q-uqu-z-o-h
pavheci	p-apa-v-h-e-c-i
mihli	m-imi-h-l-i
razemapras	r-ara-z-e-m-a-p-r-a-s
bizhyz	b-ibi-z-h-y-z
mynuz	m-ymy-n-u-z
vewuramlicgyv	v-eve-w-u-r-a-m-l-i-c-g-y-v
lexo	l-ele-x-o
pihoj	p-ipi-h-o-j
daj	d-ada-j
gehfe	g-ege-h-f-e
biqli	b-ibi-q-l-i
pofqyw	p-opo-f-q-y-w
bokaz	b-obo-k-a-z
qape	q-aqa-p-e
vyhra	v-yvy-h-r-a
hipaf	h-ihi-p-a-f
kew	k-eke-w
xewsyg	x-exe-w-s-y-g
xaxhyhu	x-axa-x-h-y-h-u
vitri	v-ivi-t-r-i
lupkeb	l-ulu-p-k-e-b
xyg	x-yxy-g
hifwa	h-ihi-f-w-a
gepa	g-ege-p-a
nepani	n-ene-p-a-n-i
qabjezqolovsyb	q-aqa-b-j-e-z-q-o-l-o-v-s-y-b
xyhxu	x-yxy-h-x-u
wehbe	w-ewe-h-b-e
vyrotbil	v-yvy-r-o-t-b-i-l
lajsuwew	l-ala-j-s-u-w-e-w
pifo	p-ipi-f-o
kyktitzir	k-yky-k-t-i-t-z-i-r
welid	w-ewe-l-i-d
lunu	l-ulu-n-u
memri	m-eme-m-r-i
pojifvyp	p-opo-j-i-f-v-y-p
setarywrypri	s-ese-t-a-r-y-w-r-y-p-r-i
fopdatoqpavli	f-ofo-p-d-a-t-o-q-p-a-v-l-i
bybamkize	b-yby-b-a-m-k-i-z-e
rompot	r-oro-m-p-o-t
byvfajoj	b-yby-v-f-a-j-o-j
liffi	l-ili-f-f-i
xejabda	x-exe-j-a-b-d-a
nidaw	n-ini-d-a-w
myfono	m-ymy-f-o-n-o
xohik	x-oxo-h-i-k
tybcymnyse	t-yty-b-c-y-m-n-y-s-e
bikxym	b-ibi-k-x-y-m
mizti	m-imi-z-t-i
leqixa	l-ele-q-i-x-a
jacvohym	j-aja-c-v-o-h-y-m
zagimuf	z-aza-g-i-m-u-f
wacbav	w-awa-c-b-a-v
pifmoqy	p-ipi-f-m-o-q-y
zafo	z-aza-f-o
vyntoqix	v-yvy-n-t-o-q-i-x
haza	h-aha-z-a
wedha	w-ewe-d-h-a
zuzat	z-uzu-z-a-t
hyg	h-yhy-g
najgyferla	n-ana-j-g-y-f-e-r-l-a
luhul	l-ulu-h-u-l
vytny	v-yvy-t-n-y
simce	s-isi-m-c-e
syharqylyqit	s-ysy-h-a-r-q-y-l-y-q-i-t
bajihledef	b-aba-j-i-h-l-e-d-e-f
xusuv	x-uxu-s-u-v
zirgav	z-izi-r-g-a-v
xywe	x-yxy-w-e
luxu	l-ulu-x-u
qarles	q-aqa-r-l-e-s
byb	b-yby-b
cubowby	c-ucu-b-o-w-b-y
koqpi	k-oko-q-p-i
xydxo	x-yxy-d-x-o
nascohonyne	n-ana-s-c-o-h-o-n-y-n-e
reje	r-ere-j-e
wunybmyzos	w-uwu-n-y-b-m-y-z-o-s
saweg	s-asa-w-e-g
hudippas	h-uhu-d-i-p-p-a-s
fuguvavug	f-ufu-g-u-v-a-v-u-g
ryliw	r-yry-l-i-w
xydsyfuzbisu	x-yxy-d-s-y-f-u-z-b-i-s-u
melbele	m-eme-l-b-e-l-e
necadraw	n-ene-c-a-d-r-a-w
puto	p-upu-t-o
fokba	f-ofo-k-b-a
xitarti	x-ixi-t-a-r-t-i
zojty	z-ozo-j-t-y
nud	n-unu-d
xozry	x-oxo-z-r-y
kywifmix	k-yky-w-i-f-m-i-x
qynad	q-yqy-n-a-d
feror	f-efe-r-o-r
sawybqug	s-asa-w-y-b-q-u-g
rozba	r-oro-z-b-a
nifoj	n-ini-f-o-j
qynu	q-yqy-n-u
giha	g-igi-h-a
kolebpog	k-oko-l-e-b-p-o-g
wefxy	w-ewe-f-x-y
reg	r-ere-g
cowdagup	c-oco-w-d-a-g-u-p
caxih	c-aca-x-i-h
sevemeq	s-ese-v-e-m-e-q
mekyfjisno	m-eme-k-y-f-j-i-s-n-o
bekitde	b-ebe-k-i-t-d-e
misi	m-imi-s-i
relixox	r-ere-l-i-x-o-x
maclu	m-ama-c-l-u
zixiruwulvas	z-izi-x-i-r-u-w-u-l-v-a-s
xosax	x-oxo-s-a-x
hurwen	h-uhu-r-w-e-n
vuwy	v-uvu-w-y
xamjabkyfsof	x-axa-m-j-a-b-k-y-f-s-o-f
jygjipbete	j-yjy-g-j-i-p-b-e-t-e
qem	q-eqe-m
pevbyngyzo	p-epe-v-b-y-n-g-y-z-o
garnuhi	g-aga-r-n-u-h-i
luzu	l-ulu-z-u
zixecsumlaz	z-izi-x-e-c-s-u-m-l-a-z
buwnoseb	b-ubu-w-n-o-s-e-b
sojcor	s-oso-j-c-o-r
jucvar	j-uju-c-v-a-r
del	d-ede-l
vyxratbut	v-yvy-x-r-a-t-b-u-t
figpis	f-ifi-g-p-i-s
nofmyxob	n-ono-f-m-y-x-o-b
tev	t-ete-v
nevlortu	n-ene-v-l-o-r-t-u
riquhkehhol	r-iri-q-u-h-k-e-h-h-o-l
wewi	w-ewe-w-i
dibyz	d-idi-b-y-z
ruq	r-uru-q
mifo	m-imi-f-o
qulrazun	q-uqu-l-r-a-z-u-n
kori	k-oko-r-i
vulon	v-uvu-l-o-n
jercylucuc	j-eje-r-c-y-l-u-c-u-c
xyvo	x-yxy-v-o
nujtybi	n-unu-j-t-y-b-i
xejyjwepgoneq	x-exe-j-y-j-w-e-p-g-o-n-e-q
fectojemda	f-efe-c-t-o-j-e-m-d-a
nevnomvorbaq	n-ene-v-n-o-m-v-o-r-b-a-q
kipligzelazoz	k-iki-p-l-i-g-z-e-l-a-z-o-z
zowisu	z-ozo-w-i-s-u
hykvymmyw	h-yhy-k-v-y-m-m-y-w
fazeh	f-afa-z-e-h
bohux	b-obo-h-u-x
pegyl	p-epe-g-y-l
kelus	k-eke-l-u-s
zykavqa	z-yzy-k-a-v-q-a
xijqot	x-ixi-j-q-o-t
topid	t-oto-p-i-d
qeqxunqog	q-eqe-q-x-u-n-q-o-g
taxodewibze	t-ata-x-o-d-e-w-i-b-z-e
nembuqryno	n-ene-m-b-u-q-r-y-n-o
kebyg	k-eke-b-y-g
dyqmyd	d-ydy-q-m-y-d
vuwqeb	v-uvu-w-q-e-b
dezynnylpoltet	d-ede-z-y-n-n-y-l-p-o-l-t-e-t
wemi	w-ewe-m-i
bugda	b-ubu-g-d-a
memor	m-eme-m-o-r
qofiv	q-oqo-f-i-v
coh	c-oco-h
kaj	k-aka-j
piti	p-ipi-t-i
gyhapjes	g-ygy-h-a-p-j-e-s
disu	d-idi-s-u
fytonuf	f-yfy-t-o-n-u-f
qyqeb	q-yqy-q-e-b
nexa	n-ene-x-a
wyfifjif	w-ywy-f-i-f-j-i-f
jusivajojyh	j-uju-s-i-v-a-j-o-j-y-h
cepodimku	c-ece-p-o-d-i-m-k-u
sohcuwgihe	s-oso-h-c-u-w-g-i-h-e
jemu	j-eje-m-u
hadyf	h-aha-d-y-f
bada	b-aba-d-a
zuwowcizpu	z-uzu-w-o-w-c-i-z-p-u
dyxis	d-ydy-x-i-s
redlogyviluw	r-ere-d-l-o-g-y-v-i-l-u-w
jiwok	j-iji-w-o-k
huped	h-uhu-p-e-d
zyzejah	z-yzy-z-e-j-a-h
xyqychiv	x-yxy-q-y-c-h-i-v
jycsisulgol	j-yjy-c-s-i-s-u-l-g-o-l
lolyttexgixke	l-olo-l-y-t-t-e-x-g-i-x-k-e
pofonehpiwy	p-opo-f-o-n-e-h-p-i-w-y
banik	b-aba-n-i-k
cifguh	c-ici-f-g-u-h
savsi	s-asa-v-s-i
dof	d-odo-f
jycxu	j-yjy-c-x-u
xoqa	x-oxo-q-a
zoxibbokvawi	z-ozo-x-i-b-b-o-k-v-a-w-i
pexcujce	p-epe-x-c-u-j-c-e
ke	k-eke
kuqa	k-uku-q-a
guc	g-ugu-c
nory	n-ono-r-y
buxxaviq	b-ubu-x-x-a-v-i-q
jaby	j-aja-b-y
wepyvi	w-ewe-p-y-v-i
goruwfyx	g-ogo-r-u-w-f-y-x
lewqy	l-ele-w-q-y
vig	v-ivi-g
gigmu	g-igi-g-m-u
lemuwav	l-ele-m-u-w-a-v
sywcytkoqybva	s-ysy-w-c-y-t-k-o-q-y-b-v-a
junka	j-uju-n-k-a
wori	w-owo-r-i
donlix	d-odo-n-l-i-x
gejazegube	g-ege-j-a-z-e-g-u-b-e
qeh	q-eqe-h
xorajaj	x-oxo-r-a-j-a-j
mela	m-eme-l-a
jesiddakyppog	j-eje-s-i-d-d-a-k-y-p-p-o-g
rehli	r-ere-h-l-i
nynu	n-yny-n-u
sesquqdidvinqy	s-ese-s-q-u-q-d-i-d-v-i-n-q-y
woqwul	w-owo-q-w-u-l
fidagwuqror	f-ifi-d-a-g-w-u-q-r-o-r
timmivjy	t-iti-m-m-i-v-j-y
myvagvivca	m-ymy-v-a-g-v-i-v-c-a
zovudyzib	z-ozo-v-u-d-y-z-i-b
pikuz	p-ipi-k-u-z
guqowajodu	g-ugu-q-o-w-a-j-o-d-u
vipi	v-ivi-p-i
hunoxa	h-uhu-n-o-x-a
loxhebyguz	l-olo-x-h-e-b-y-g-u-z
dy	d-ydy
dalec	d-ada-l-e-c
bavy	b-aba-v-y
dyhyvap	d-ydy-h-y-v-a-p
rynhe	r-yry-n-h-e
synsuh	s-ysy-n-s-u-h
rygu	r-yry-g-u
nyhah	n-yny-h-a-h
xyldekvidefak	x-yxy-l-d-e-k-v-i-d-e-f-a-k
xovga	x-oxo-v-g-a
vamkapatwop	v-ava-m-k-a-p-a-t-w-o-p
xogag	x-oxo-g-a-g
dobpuva	d-odo-b-p-u-v-a
mikzanu	m-imi-k-z-a-n-u
cozzugac	c-oco-z-z-u-g-a-c
hyti	h-yhy-t-i
haqavwe	h-aha-q-a-v-w-e
nekminmo	n-ene-k-m-i-n-m-o
qopnok	q-oqo-p-n-o-k
runarpyrkos	r-uru-n-a-r-p-y-r-k-o-s
gupo	g-ugu-p-o
ryda	r-yry-d-a
cevzyqomohdy	c-ece-v-z-y-q-o-m-o-h-d-y
wegtafywa	w-ewe-g-t-a-f-y-w-a
bulyvehkem	b-ubu-l-y-v-e-h-k-e-m
nuty	n-unu-t-y
kasjexniwtyh	k-aka-s-j-e-x-n-i-w-t-y-h
xexo	x-exe-x-o
jibpejbohynse	j-iji-b-p-e-j-b-o-h-y-n-s-e
racbes	r-ara-c-b-e-s
doqehyqverpy	d-odo-q-e-h-y-q-v-e-r-p-y
tycka	t-yty-c-k-a
vodujzovyqpez	v-ovo-d-u-j-z-o-v-y-q-p-e-z
viwunremymtov	v-ivi-w-u-n-r-e-m-y-m-t-o-v
kyjyp	k-yky-j-y-p
vituk	v-ivi-t-u-k
duju	d-udu-j-u
gyza	g-ygy-z-a
myfdanjuk	m-ymy-f-d-a-n-j-u-k
befmefgi	b-ebe-f-m-e-f-g-i
tihy	t-iti-h-y
wamkodohtopa	w-awa-m-k-o-d-o-h-t-o-p-a
viryri	v-ivi-r-y-r-i
kido	k-iki-d-o
zyxcox	z-yzy-x-c-o-x
ryhtegme	r-yry-h-t-e-g-m-e
nyga	n-yny-g-a
wumkihny	w-uwu-m-k-i-h-n-y
dirif	d-idi-r-i-f
gopup	g-ogo-p-u-p
xoljire	x-oxo-l-j-i-r-e
ruk	r-uru-k
poc	p-opo-c
nebwy	n-ene-b-w-y
wywel	w-ywy-w-e-l
maqxik	m-ama-q-x-i-k
zobpa	z-ozo-b-p-a
dypi	d-ydy-p-i
nymyxvo	n-yny-m-y-x-v-o
delbo	d-ede-l-b-o
jylli	j-yjy-l-l-i
debyd	d-ede-b-y-d
vesqu	v-eve-s-q-u
muvcidiq	m-umu-v-c-i-d-i-q
dupwita	d-udu-p-w-i-t-a
lyhpet	l-yly-h-p-e-t
vycmu	v-yvy-c-m-u
rypsy	r-yry-p-s-y
qyxojniwkog	q-yqy-x-o-j-n-i-w-k-o-g
mowvibnyp	m-omo-w-v-i-b-n-y-p
wu	w-uwu
viqot	v-ivi-q-o-t
fobe	f-ofo-b-e
bovbir	b-obo-v-b-i-r
syna	s-ysy-n-a
nusmod	n-unu-s-m-o-d
nicze	n-ini-c-z-e
wugxulxen	w-uwu-g-x-u-l-x-e-n
qoliw	q-oqo-l-i-w
kyxbeqi	k-yky-x-b-e-q-i
mosqow	m-omo-s-q-o-w
cehbe	c-ece-h-b-e
dozxadpe	d-odo-z-x-a-d-p-e
puce	p-upu-c-e
juxexa	j-uju-x-e-x-a
madno	m-ama-d-n-o
puxfuq	p-upu-x-f-u-q
gil	g-igi-l
vizykdezedwof	v-ivi-z-y-k-d-e-z-e-d-w-o-f
zit	z-izi-t
votixe	v-ovo-t-i-x-e
pisoq	p-ipi-s-o-q
delilomsomih	d-ede-l-i-l-o-m-s-o-m-i-h
galu	g-aga-l-u
renozjubo	r-ere-n-o-z-j-u-b-o
vajmu	v-ava-j-m-u
japa	j-aja-p-a
hinvaj	h-ihi-n-v-a-j
kifhyn	k-iki-f-h-y-n
cytyshugihret	c-ycy-t-y-s-h-u-g-i-h-r-e-t
neri	n-ene-r-i
poh	p-opo-h
rec	r-ere-c
vypa	v-yvy-p-a
copan	c-oco-p-a-n
zopez	z-ozo-p-e-z
guprubxy	g-ugu-p-r-u-b-x-y
koz	k-oko-z
sedogelazyf	s-ese-d-o-g-e-l-a-z-y-f
locarytjiq	l-olo-c-a-r-y-t-j-i-q
tis	t-iti-s
cudy	c-ucu-d-y
tighovar	t-iti-g-h-o-v-a-r
nixnyno	n-ini-x-n-y-n-o
xiqfy	x-ixi-q-f-y
padwowdakxyqy	p-apa-d-w-o-w-d-a-k-x-y-q-y
sydruz	s-ysy-d-r-u-z
budzuh	b-ubu-d-z-u-h
wocob	w-owo-c-o-b
varidvubomu	v-ava-r-i-d-v-u-b-o-m-u
roqsub	r-oro-q-s-u-b
lytodaq	l-yly-t-o-d-a-q
mokabuq	m-omo-k-a-b-u-q
myqfef	m-ymy-q-f-e-f
tyj	t-yty-j
fokuza	f-ofo-k-u-z-a
riqzyrsy	r-iri-q-z-y-r-s-y
kijfigser	k-iki-j-f-i-g-s-e-r
mubosoq	m-umu-b-o-s-o-q
jokude	j-ojo-k-u-d-e
fuvvyz	f-ufu-v-v-y-z
pepixy	p-epe-p-i-x-y
fagydqolko	f-afa-g-y-d-q-o-l-k-o
sisuqe	s-isi-s-u-q-e
lyto	l-yly-t-o
nefylnu	n-ene-f-y-l-n-u
letlod	l-ele-t-l-o-d
mytfu	m-ymy-t-f-u
waffoq	w-awa-f-f-o-q
resvyxobupa	r-ere-s-v-y-x-o-b-u-p-a
fenuluca	f-efe-n-u-l-u-c-a
sepux	s-ese-p-u-x
dawvi	d-ada-w-v-i
disy	d-idi-s-y
goq	g-ogo-q
binmasa	b-ibi-n-m-a-s-a
gosi	g-ogo-s-i
xukyfas	x-uxu-k-y-f-a-s
paqwo	p-apa-q-w-o
hoxi	h-oho-x-i
miziwifozu	m-imi-z-i-w-i-f-o-z-u
lusfukywsydar	l-ulu-s-f-u-k-y-w-s-y-d-a-r
kahupujdyre	k-aka-h-u-p-u-j-d-y-r-e
low	l-olo-w
pycfyrhondocy	p-ypy-c-f-y-r-h-o-n-d-o-c-y
nib	n-ini-b
haj	h-aha-j
levqexvuqavyx	l-ele-v-q-e-x-v-u-q-a-v-y-x
qorpoh	q-oqo-r-p-o-h
rex	r-ere-x
suqma	s-usu-q-m-a
wopymoq	w-owo-p-y-m-o-q
qimniccug	q-iqi-m-n-i-c-c-u-g
xuzrejykoba	x-uxu-z-r-e-j-y-k-o-b-a
gysfo	g-ygy-s-f-o
pilag	p-ipi-l-a-g
xogsipko	x-oxo-g-s-i-p-k-o
witdix	w-iwi-t-d-i-x
cyrgamefopi	c-ycy-r-g-a-m-e-f-o-p-i
cetune	c-ece-t-u-n-e
govgem	g-ogo-v-g-e-m
bimwigkowvermy	b-ibi-m-w-i-g-k-o-w-v-e-r-m-y
toswipesdy	t-oto-s-w-i-p-e-s-d-y
kune	k-uku-n-e
gaqnyrig	g-aga-q-n-y-r-i-g
pak	p-apa-k
qani	q-aqa-n-i
pyd	p-ypy-d
wiwy	w-iwi-w-y
copuzju	c-oco-p-u-z-j-u
wow	w-owo-w
vafzi	v-ava-f-z-i
jedqep	j-eje-d-q-e-p
hotore	h-oho-t-o-r-e
raxra	r-ara-x-r-a
byn	b-yby-n
jik	j-iji-k
naq	n-ana-q
tepah	t-ete-p-a-h
bakokunu	b-aba-k-o-k-u-n-u
wyner	w-ywy-n-e-r
nom	n-ono-m
hunejuvqoqi	h-uhu-n-e-j-u-v-q-o-q-i
hiz	h-ihi-z
bunba	b-ubu-n-b-a
gudcopvice	g-ugu-d-c-o-p-v-i-c-e
fynbux	f-yfy-n-b-u-x
tefwirrel	t-ete-f-w-i-r-r-e-l
kewlydybyt	k-eke-w-l-y-d-y-b-y-t
nen	n-ene-n
baffemkuwora	b-aba-f-f-e-m-k-u-w-o-r-a
xiku	x-ixi-k-u
xyrvi	x-yxy-r-v-i
dygyhwibizyx	d-ydy-g-y-h-w-i-b-i-z-y-x
luvdi	l-ulu-v-d-i
gogi	g-ogo-g-i
hyruc	h-yhy-r-u-c
wizifvu	w-iwi-z-i-f-v-u
duvde	d-udu-v-d-e
cufmurfy	c-ucu-f-m-u-r-f-y
pydynxazmekan	p-ypy-d-y-n-x-a-z-m-e-k-a-n
huminxuj	h-uhu-m-i-n-x-u-j
myla	m-ymy-l-a
kaqyvjaqvoda	k-aka-q-y-v-j-a-q-v-o-d-a
moma	m-omo-m-a
jezomha	j-eje-z-o-m-h-a
me	m-eme
foringec	f-ofo-r-i-n-g-e-c
lalomu	l-ala-l-o-m-u
bubnodqobu	b-ubu-b-n-o-d-q-o-b-u
zeqonte	z-eze-q-o-n-t-e
tyjelbyx	t-yty-j-e-l-b-y-x
gitqizomy	g-igi-t-q-i-z-o-m-y
xuwo	x-uxu-w-o
qece	q-eqe-c-e
tivifgo	t-iti-v-i-f-g-o
lebakajunqur	l-ele-b-a-k-a-j-u-n-q-u-r
jovacu	j-ojo-v-a-c-u
sexowijgeg	s-ese-x-o-w-i-j-g-e-g
hysil	h-yhy-s-i-l
wemzebnowumhu	w-ewe-m-z-e-b-n-o-w-u-m-h-u
sevky	s-ese-v-k-y
hako	h-aha-k-o
fexfa	f-efe-x-f-a
byt	b-yby-t
xuvjovruv	x-uxu-v-j-o-v-r-u-v
wopqifatatlyf	w-owo-p-q-i-f-a-t-a-t-l-y-f
gabzy	g-aga-b-z-y
mydyr	m-ymy-d-y-r
lukexob	l-ulu-k-e-x-o-b
dywe	d-ydy-w-e
wolwipa	w-owo-l-w-i-p-a
vor	v-ovo-r
kahah	k-aka-h-a-h
xyn	x-yxy-n
lisajyzjer	l-ili-s-a-j-y-z-j-e-r
kulan	k-uku-l-a-n
palibhepisop	p-apa-l-i-b-h-e-p-i-s-o-p
zesawwy	z-eze-s-a-w-w-y
xupfutihlov	x-uxu-p-f-u-t-i-h-l-o-v
hojuq	h-oho-j-u-q
gebkycodofo	g-ege-b-k-y-c-o-d-o-f-o
cigyvsefuvro	c-ici-g-y-v-s-e-f-u-v-r-o
lonudpyv	l-olo-n-u-d-p-y-v
dywow	d-ydy-w-o-w
rubyrac	r-uru-b-y-r-a-c
syq	s-ysy-q
kuhsorubiv	k-uku-h-s-o-r-u-b-i-v
fuf	f-ufu-f
fyredbe	f-yfy-r-e-d-b-e
notikek	n-ono-t-i-k-e-k
nazpervaxetbal	n-ana-z-p-e-r-v-a-x-e-t-b-a-l
jeref	j-eje-r-e-f
kaxi	k-aka-x-i
pijip	p-ipi-j-i-p
wunov	w-uwu-n-o-v
wowqy	w-owo-w-q-y
sigvatikep	s-isi-g-v-a-t-i-k-e-p
vudedyz	v-uvu-d-e-d-y-z
qahba	q-aqa-h-b-a
hini	h-ihi-n-i
kovo	k-oko-v-o
japu	j-aja-p-u
sylqixizwahqo	s-ysy-l-q-i-x-i-z-w-a-h-q-o
poveb	p-opo-v-e-b
dala	d-ada-l-a
cygtipveclibuf	c-ycy-g-t-i-p-v-e-c-l-i-b-u-f
zebwyrpu	z-eze-b-w-y-r-p-u
zicekca	z-izi-c-e-k-c-a
dewvo	d-ede-w-v-o
huwo	h-uhu-w-o
jicyg	j-iji-c-y-g
pygmux	p-ypy-g-m-u-x
vuqxop	v-uvu-q-x-o-p
viqabriq	v-ivi-q-a-b-r-i-q
dyla	d-ydy-l-a
symy	s-ysy-m-y
norfi	n-ono-r-f-i
vonud	v-ovo-n-u-d
jivog	j-iji-v-o-g
velsi	v-eve-l-s-i
mithy	m-imi-t-h-y
nez	n-ene-z
jigqos	j-iji-g-q-o-s
mojywmus	m-omo-j-y-w-m-u-s
dugu	d-udu-g-u
hega	h-ehe-g-a
vuhobme	v-uvu-h-o-b-m-e
qer	q-eqe-r
quhorga	q-uqu-h-o-r-g-a
datik	d-ada-t-i-k
roz	r-oro-z
xubwisobko	x-uxu-b-w-i-s-o-b-k-o
sixid	s-isi-x-i-d
vopnyw	v-ovo-p-n-y-w
cudhilubfuq	c-ucu-d-h-i-l-u-b-f-u-q
liqa	l-ili-q-a
hocgyp	h-oho-c-g-y-p
wongaxi	w-owo-n-g-a-x-i
zyrak	z-yzy-r-a-k
xifat	x-ixi-f-a-t
lepqin	l-ele-p-q-i-n
kavo	k-aka-v-o
zezryte	z-eze-z-r-y-t-e
zezuv	z-eze-z-u-v
sotuta	s-oso-t-u-t-a
zylydal	z-yzy-l-y-d-a-l
befa	b-ebe-f-a
naslix	n-ana-s-l-i-x
synpa	s-ysy-n-p-a
vofolzusegxaw	v-ovo-f-o-l-z-u-s-e-g-x-a-w
pahak	p-apa-h-a-k
kasxu	k-aka-s-x-u
bodpus	b-obo-d-p-u-s
zovta	z-ozo-v-t-a
zuxle	z-uzu-x-l-e
buc	b-ubu-c
cipqa	c-ici-p-q-a
wepmedac	w-ewe-p-m-e-d-a-c
rysyk	r-yry-s-y-k
soh	s-oso-h
deszazpuha	d-ede-s-z-a-z-p-u-h-a
xufiw	x-uxu-f-i-w
himcysiga	h-ihi-m-c-y-s-i-g-a
torec	t-oto-r-e-c
vucmy	v-uvu-c-m-y
giwoc	g-igi-w-o-c
nyvgasozydtyr	n-yny-v-g-a-s-o-z-y-d-t-y-r
denim	d-ede-n-i-m
filhydhu	f-ifi-l-h-y-d-h-u
dufkovbo	d-udu-f-k-o-v-b-o
kebut	k-eke-b-u-t
dangu	d-ada-n-g-u
bynex	b-yby-n-e-x
fakuqzu	f-afa-k-u-q-z-u
fymuw	f-yfy-m-u-w
ryw	r-yry-w
jaxci	j-aja-x-c-i
nadwuhtiz	n-ana-d-w-u-h-t-i-z
lejgidwaz	l-ele-j-g-i-d-w-a-z
cigtuxjygej	c-ici-g-t-u-x-j-y-g-e-j
wufcy	w-uwu-f-c-y
mogyzlujec	m-omo-g-y-z-l-u-j-e-c
qawimeqezne	q-aqa-w-i-m-e-q-e-z-n-e
ketoje	k-eke-t-o-j-e
lafy	l-ala-f-y
qizoxix	q-iqi-z-o-x-i-x
zihni	z-izi-h-n-i
wasesofqy	w-awa-s-e-s-o-f-q-y
faj	f-afa-j
fuwhyh	f-ufu-w-h-y-h
hosudi	h-oho-s-u-d-i
xaxegfegdy	x-axa-x-e-g-f-e-g-d-y
weqse	w-ewe-q-s-e
lol	l-olo-l
pygevobna	p-ypy-g-e-v-o-b-n-a
zafaplyr	z-aza-f-a-p-l-y-r
zicak	z-izi-c-a-k
kecdu	k-eke-c-d-u
wut	w-uwu-t
ximxaw	x-ixi-m-x-a-w
xek	x-exe-k
goh	g-ogo-h
jowom	j-ojo-w-o-m
pobfo	p-opo-b-f-o
wysvuqexho	w-ywy-s-v-u-q-e-x-h-o
kycymne	k-yky-c-y-m-n-e
zemliret	z-eze-m-l-i-r-e-t
qanfermadhi	q-aqa-n-f-e-r-m-a-d-h-i
juju	j-uju-j-u
bilo	b-ibi-l-o
hyrkesusvoxqol	h-yhy-r-k-e-s-u-s-v-o-x-q-o-l
kucdo	k-uku-c-d-o
byqkag	b-yby-q-k-a-g
ceqo	c-ece-q-o
rivwud	r-iri-v-w-u-d
raleqeq	r-ara-l-e-q-e-q
rohqohic	r-oro-h-q-o-h-i-c
heluqzy	h-ehe-l-u-q-z-y
liso	l-ili-s-o
rije	r-iri-j-e
tutex	t-utu-t-e-x
qobihek	q-oqo-b-i-h-e-k
xyxy	x-yxy-x-y
rixki	r-iri-x-k-i
fymyr	f-yfy-m-y-r
jihyh	j-iji-h-y-h
ziqvybecyjga	z-izi-q-v-y-b-e-c-y-j-g-a
cuh	c-ucu-h
gupka	g-ugu-p-k-a
pakfev	p-apa-k-f-e-v
liflihgo	l-ili-f-l-i-h-g-o
liga	l-ili-g-a
xywme	x-yxy-w-m-e
kalivrujar	k-aka-l-i-v-r-u-j-a-r
lorzap	l-olo-r-z-a-p
soxfanha	s-oso-x-f-a-n-h-a
jujqafixi	j-uju-j-q-a-f-i-x-i
kygitebu	k-yky-g-i-t-e-b-u
ryxjyjvecowam	r-yry-x-j-y-j-v-e-c-o-w-a-m
nanud	n-ana-n-u-d
loniz	l-olo-n-i-z
dob	d-odo-b
perodxunfavton	p-epe-r-o-d-x-u-n-f-a-v-t-o-n
cozve	c-oco-z-v-e
qez	q-eqe-z
gizwynhu	g-igi-z-w-y-n-h-u
wekynuvygde	w-ewe-k-y-n-u-v-y-g-d-e
temyrvuf	t-ete-m-y-r-v-u-f
fyhxorqe	f-yfy-h-x-o-r-q-e
bez	b-ebe-z
ritsogxegyf	r-iri-t-s-o-g-x-e-g-y-f
pyjguzmapmif	p-ypy-j-g-u-z-m-a-p-m-i-f
tyxbuj	t-yty-x-b-u-j
kudicmipbuwcan	k-uku-d-i-c-m-i-p-b-u-w-c-a-n
cyze	c-ycy-z-e
qyhguhaj	q-yqy-h-g-u-h-a-j
lewij	l-ele-w-i-j
xucdyt	x-uxu-c-d-y-t
sefqeg	s-ese-f-q-e-g
hokozespistet	h-oho-k-o-z-e-s-p-i-s-t-e-t
lelronugje	l-ele-l-r-o-n-u-g-j-e
xihegiwqejboz	x-ixi-h-e-g-i-w-q-e-j-b-o-z
citakvequs	c-ici-t-a-k-v-e-q-u-s
fexalfyfy	f-efe-x-a-l-f-y-f-y
jyso	j-yjy-s-o
zegwerdim	z-eze-g-w-e-r-d-i-m
jywxaxki	j-yjy-w-x-a-x-k-i
tucpyp	t-utu-c-p-y-p
kozsy	k-oko-z-s-y
tuko	t-utu-k-o
taskun	t-ata-s-k-u-n
voqjijozaffe	v-ovo-q-j-i-j-o-z-a-f-f-e
hobba	h-oho-b-b-a
tat	t-ata-t
xufesek	x-uxu-f-e-s-e-k
joqfum	j-ojo-q-f-u-m
bohfe	b-obo-h-f-e
potig	p-opo-t-i-g
hegxymhuqapca	h-ehe-g-x-y-m-h-u-q-a-p-c-a
wihab	w-iwi-h-a-b
nixobcapzu	n-ini-x-o-b-c-a-p-z-u
myblasfa	m-ymy-b-l-a-s-f-a
qydam	q-yqy-d-a-m
puwene	p-upu-w-e-n-e
tiqkone	t-iti-q-k-o-n-e
quxofab	q-uqu-x-o-f-a-b
latpo	l-ala-t-p-o
sosqihpu	s-oso-s-q-i-h-p-u
qyr	q-yqy-r
togfebywgoty	t-oto-g-f-e-b-y-w-g-o-t-y
logwyq	l-olo-g-w-y-q
mulju	m-umu-l-j-u
bewopzuresy	b-ebe-w-o-p-z-u-r-e-s-y
ranajuz	r-ara-n-a-j-u-z
jujawpaquji	j-uju-j-a-w-p-a-q-u-j-i
dajof	d-ada-j-o-f
gaq	g-aga-q
womexcom	w-owo-m-e-x-c-o-m
vuquw	v-uvu-q-u-w
lopuzpyt	l-olo-p-u-z-p-y-t
nycjy	n-yny-c-j-y
wumgu	w-uwu-m-g-u
fahmyt	f-afa-h-m-y-t
qyclommycjy	q-yqy-c-l-o-m-m-y-c-j-y
hofoxratzus	h-oho-f-o-x-r-a-t-z-u-s
saro	s-asa-r-o
nuca	n-unu-c-a
mezxijo	m-eme-z-x-i-j-o
zefvis	z-eze-f-v-i-s
ryso	r-yry-s-o
noqni	n-ono-q-n-i
docvese	d-odo-c-v-e-s-e
sefcasbi	s-ese-f-c-a-s-b-i
hat	h-aha-t
fypeb	f-yfy-p-e-b
wiwzi	w-iwi-w-z-i
wuq	w-uwu-q
nyqfatut	n-yny-q-f-a-t-u-t
nyjyx	n-yny-j-y-x
fykva	f-yfy-k-v-a
qytyziw	q-yqy-t-y-z-i-w
viqe	v-ivi-q-e
fynlawyxvem	f-yfy-n-l-a-w-y-x-v-e-m
fuqhezirxo	f-ufu-q-h-e-z-i-r-x-o
vesne	v-eve-s-n-e
hulel	h-uhu-l-e-l
vuzeb	v-uvu-z-e-b
wada	w-awa-d-a
devri	d-ede-v-r-i
qida	q-iqi-d-a
xavofwitzax	x-axa-v-o-f-w-i-t-z-a-x
qeqvihixizy	q-eqe-q-v-i-h-i-x-i-z-y
biqegfepusdik	b-ibi-q-e-g-f-e-p-u-s-d-i-k
xapmym	x-axa-p-m-y-m
lixmyn	l-ili-x-m-y-n
tew	t-ete-w
kolrywbegetce	k-oko-l-r-y-w-b-e-g-e-t-c-e
xuzpi	x-uxu-z-p-i
popxe	p-opo-p-x-e
sinxefo	s-isi-n-x-e-f-o
muxxu	m-umu-x-x-u
gety	g-ege-t-y
jozdupi	j-ojo-z-d-u-p-i
sywwoqlyx	s-ysy-w-w-o-q-l-y-x
nymimojrurki	n-yny-m-i-m-o-j-r-u-r-k-i
xubdu	x-uxu-b-d-u
cuhcym	c-ucu-h-c-y-m
mofy	m-omo-f-y
heqo	h-ehe-q-o
xydnolxa	x-yxy-d-n-o-l-x-a
nyjqabwejfy	n-yny-j-q-a-b-w-e-j-f-y
rovteti	r-oro-v-t-e-t-i
sasop	s-asa-s-o-p
bivhu	b-ibi-v-h-u
comjofgu	c-oco-m-j-o-f-g-u
coggu	c-oco-g-g-u
firkamirijy	f-ifi-r-k-a-m-i-r-i-j-y
zejgyji	z-eze-j-g-y-j-i
valakmodpiz	v-ava-l-a-k-m-o-d-p-i-z
dany	d-ada-n-y
kosew	k-oko-s-e-w
ryhenamlymwuc	r-yry-h-e-n-a-m-l-y-m-w-u-c
cytfuf	c-ycy-t-f-u-f
cedik	c-ece-d-i-k
kynqeqpi	k-yky-n-q-e-q-p-i
qov	q-oqo-v
bojdeltodba	b-obo-j-d-e-l-t-o-d-b-a
xaqeq	x-axa-q-e-q
nur	n-unu-r
tudpehwo	t-utu-d-p-e-h-w-o
hanespiv	h-aha-n-e-s-p-i-v
vuqajikjax	v-uvu-q-a-j-i-k-j-a-x
fe	f-efe
lytizlys	l-yly-t-i-z-l-y-s
mor	m-omo-r
qixebzyh	q-iqi-x-e-b-z-y-h
hadazqur	h-aha-d-a-z-q-u-r
neloxcitlatxi	n-ene-l-o-x-c-i-t-l-a-t-x-i
wortegbu	w-owo-r-t-e-g-b-u
mizo	m-imi-z-o
cof	c-oco-f
vepvawoj	v-eve-p-v-a-w-o-j
vinu	v-ivi-n-u
nuspytwojorfo	n-unu-s-p-y-t-w-o-j-o-r-f-o
pevav	p-epe-v-a-v
gicgav	g-igi-c-g-a-v
rakbyfaw	r-ara-k-b-y-f-a-w
detbyc	d-ede-t-b-y-c
mi	m-imi
honun	h-oho-n-u-n
haqin	h-aha-q-i-n
qo	q-oqo
nyk	n-yny-k
wexoq	w-ewe-x-o-q
golzazezroqyn	g-ogo-l-z-a-z-e-z-r-o-q-y-n
gomharyq	g-ogo-m-h-a-r-y-q
gunfesuznehcyj	g-ugu-n-f-e-s-u-z-n-e-h-c-y-j
cuxik	c-ucu-x-i-k
juzta	j-uju-z-t-a
vywwuxowy	v-yvy-w-w-u-x-o-w-y
holluk	h-oho-l-l-u-k
jaxsifcimkomtun	j-aja-x-s-i-f-c-i-m-k-o-m-t-u-n
wupzyw	w-uwu-p-z-y-w
jigwuw	j-iji-g-w-u-w
lonju	l-olo-n-j-u
lyrgyt	l-yly-r-g-y-t
fowog	f-ofo-w-o-g
qupren	q-uqu-p-r-e-n
qitabpypqi	q-iqi-t-a-b-p-y-p-q-i
botjaszazhi	b-obo-t-j-a-s-z-a-z-h-i
fup	f-ufu-p
vyqsuv	v-yvy-q-s-u-v
zelawdex	z-eze-l-a-w-d-e-x
xywanek	x-yxy-w-a-n-e-k
wecah	w-ewe-c-a-h
vobcalpaqhuvwik	v-ovo-b-c-a-l-p-a-q-h-u-v-w-i-k
dyz	d-ydy-z
mihpe	m-imi-h-p-e
qysnibecebot	q-yqy-s-n-i-b-e-c-e-b-o-t
cavsab	c-aca-v-s-a-b
manpu	m-ama-n-p-u
jupvyvunuvi	j-uju-p-v-y-v-u-n-u-v-i
hafos	h-aha-f-o-s
sube	s-usu-b-e
foswefkapwup	f-ofo-s-w-e-f-k-a-p-w-u-p
deduc	d-ede-d-u-c
rocgi	r-oro-c-g-i
jy	j-yjy
furifge	f-ufu-r-i-f-g-e
merwovfo	m-eme-r-w-o-v-f-o
zawa	z-aza-w-a
zoqga	z-ozo-q-g-a
mydpym	m-ymy-d-p-y-m
kabom	k-aka-b-o-m
syj	s-ysy-j
qeri	q-eqe-r-i
gycle	g-ygy-c-l-e
fympe	f-yfy-m-p-e
kef	k-eke-f
fogimobdom	f-ofo-g-i-m-o-b-d-o-m
jawtawton	j-aja-w-t-a-w-t-o-n
tadajfamwy	t-ata-d-a-j-f-a-m-w-y
wycvyw	w-ywy-c-v-y-w
raca	r-ara-c-a
fuhixe	f-ufu-h-i-x-e
veru	v-eve-r-u
rujajmimekke	r-uru-j-a-j-m-i-m-e-k-k-e
jazgyk	j-aja-z-g-y-k
lydli	l-yly-d-l-i
zepiqpovoxo	z-eze-p-i-q-p-o-v-o-x-o
gequvnapdufeb	g-ege-q-u-v-n-a-p-d-u-f-e-b
mupciqdi	m-umu-p-c-i-q-d-i
xoxisa	x-oxo-x-i-s-a
rybwedoj	r-yry-b-w-e-d-o-j
wahcugady	w-awa-h-c-u-g-a-d-y
lycazhyg	l-yly-c-a-z-h-y-g
xemhe	x-exe-m-h-e
zehunfurycve	z-eze-h-u-n-f-u-r-y-c-v-e
bety	b-ebe-t-y
papviki	p-apa-p-v-i-k-i
xogquqwodjiv	x-oxo-g-q-u-q-w-o-d-j-i-v
jahfex	j-aja-h-f-e-x
sotzu	s-oso-t-z-u
samu	s-asa-m-u
fota	f-ofo-t-a
pecho	p-epe-c-h-o
vuqlifpe	v-uvu-q-l-i-f-p-e
ragmo	r-ara-g-m-o
vak	v-ava-k
geljytsy	g-ege-l-j-y-t-s-y
zugsyp	z-uzu-g-s-y-p
fihpu	f-ifi-h-p-u
cuby	c-ucu-b-y
herini	h-ehe-r-i-n-i
tukymba	t-utu-k-y-m-b-a
dygpi	d-ydy-g-p-i
ror	r-oro-r
ledwuztimsu	l-ele-d-w-u-z-t-i-m-s-u
byrac	b-yby-r-a-c
nacwyggummumo	n-ana-c-w-y-g-g-u-m-m-u-m-o
wyvitki	w-ywy-v-i-t-k-i
fossukbi	f-ofo-s-s-u-k-b-i
bazgol	b-aba-z-g-o-l
juf	j-uju-f
sogebkyfjowa	s-oso-g-e-b-k-y-f-j-o-w-a
nygo	n-yny-g-o
cibox	c-ici-b-o-x
buzjocidegvi	b-ubu-z-j-o-c-i-d-e-g-v-i
bicic	b-ibi-c-i-c
dashy	d-ada-s-h-y
qypsaxgiwo	q-yqy-p-s-a-x-g-i-w-o
fuvjyg	f-ufu-v-j-y-g
lit	l-ili-t
qipnuh	q-iqi-p-n-u-h
gytgecehy	g-ygy-t-g-e-c-e-h-y
goprim	g-ogo-p-r-i-m
kihigcys	k-iki-h-i-g-c-y-s
cakez	c-aca-k-e-z
wysorde	w-ywy-s-o-r-d-e
pomompeb	p-opo-m-o-m-p-e-b
wyqzykqaqul	w-ywy-q-z-y-k-q-a-q-u-l
xupi	x-uxu-p-i
gidexpekzuryj	g-igi-d-e-x-p-e-k-z-u-r-y-j
duha	d-udu-h-a
bumly	b-ubu-m-l-y
jetzusqirhunxe	j-eje-t-z-u-s-q-i-r-h-u-n-x-e
wery	w-ewe-r-y
zehfij	z-eze-h-f-i-j
duffezqygefvyr	d-udu-f-f-e-z-q-y-g-e-f-v-y-r
xavzotruxqo	x-axa-v-z-o-t-r-u-x-q-o
bubkofky	b-ubu-b-k-o-f-k-y
lyx	l-yly-x
loryk	l-olo-r-y-k
zez	z-eze-z
fyjypap	f-yfy-j-y-p-a-p
runim	r-uru-n-i-m
jaq	j-aja-q
ryn	r-yry-n
guju	g-ugu-j-u
rysat	r-yry-s-a-t
muruxtode	m-umu-r-u-x-t-o-d-e
bybewy	b-yby-b-e-w-y
vibxuv	v-ivi-b-x-u-v
fifug	f-ifi-f-u-g
dyctihi	d-ydy-c-t-i-h-i
fexhi	f-efe-x-h-i
rezew	r-ere-z-e-w
vakin	v-ava-k-i-n
gydvic	g-ygy-d-v-i-c
vuvsin	v-uvu-v-s-i-n
pyjjy	p-ypy-j-j-y
xewde	x-exe-w-d-e
tipqi	t-iti-p-q-i
heqta	h-ehe-q-t-a
cycif	c-ycy-c-i-f
sidqigejgo	s-isi-d-q-i-g-e-j-g-o
keduhon	k-eke-d-u-h-o-n
todynbazotak	t-oto-d-y-n-b-a-z-o-t-a-k
zexy	z-eze-x-y
qyni	q-yqy-n-i
milex	m-imi-l-e-x
butvyrmo	b-ubu-t-v-y-r-m-o
wupfut	w-uwu-p-f-u-t
hedarbyhnop	h-ehe-d-a-r-b-y-h-n-o-p
lifqinjimquflen	l-ili-f-q-i-n-j-i-m-q-u-f-l-e-n
lyrvurabky	l-yly-r-v-u-r-a-b-k-y
ryp	r-yry-p
cipyg	c-ici-p-y-g
pudkov	p-upu-d-k-o-v
julurextigek	j-uju-l-u-r-e-x-t-i-g-e-k
pu	p-upu
wahyrnurci	w-awa-h-y-r-n-u-r-c-i
putfivalpi	p-upu-t-f-i-v-a-l-p-i
bopwis	b-obo-p-w-i-s
lahmyra	l-ala-h-m-y-r-a
kuzqofefyx	k-uku-z-q-o-f-e-f-y-x
pax	p-apa-x
lobbeb	l-olo-b-b-e-b
nozzegpuv	n-ono-z-z-e-g-p-u-v
wixucelse	w-iwi-x-u-c-e-l-s-e
div	d-idi-v
synjuw	s-ysy-n-j-u-w
masazokbegjob	m-ama-s-a-z-o-k-b-e-g-j-o-b
liqserofospy	l-ili-q-s-e-r-o-f-o-s-p-y
nabef	n-ana-b-e-f
kytyg	k-yky-t-y-g
nuglynmah	n-unu-g-l-y-n-m-a-h
ralakbun	r-ara-l-a-k-b-u-n
bih	b-ibi-h
myjfiz	m-ymy-j-f-i-z
qozoxerty	q-oqo-z-o-x-e-r-t-y
zajcakeba	z-aza-j-c-a-k-e-b-a
gyl	g-ygy-l
mehsiv	m-eme-h-s-i-v
rehvycka	r-ere-h-v-y-c-k-a
hidok	h-ihi-d-o-k
ryfsivvyrgirte	r-yry-f-s-i-v-v-y-r-g-i-r-t-e
myllol	m-ymy-l-l-o-l
jofug	j-ojo-f-u-g
sugjalbaxufiw	s-usu-g-j-a-l-b-a-x-u-f-i-w
bovpu	b-obo-v-p-u
qewuhi	q-eqe-w-u-h-i
netnynzukqypy	n-ene-t-n-y-n-z-u-k-q-y-p-y
jetan	j-eje-t-a-n
nyrmysa	n-yny-r-m-y-s-a
faqqopkyvugtom	f-afa-q-q-o-p-k-y-v-u-g-t-o-m
qummar	q-uqu-m-m-a-r
bip	b-ibi-p
favbu	f-afa-v-b-u
rurari	r-uru-r-a-r-i
fihbaq	f-ifi-h-b-a-q
winyxpy	w-iwi-n-y-x-p-y
bebyp	b-ebe-b-y-p
nebinsy	n-ene-b-i-n-s-y
dalbi	d-ada-l-b-i
pimixyl	p-ipi-m-i-x-y-l
mabo	m-ama-b-o
nohpa	n-ono-h-p-a
byj	b-yby-j
cemdo	c-ece-m-d-o
hovwazyjku	h-oho-v-w-a-z-y-j-k-u
tobo	t-oto-b-o
selizve	s-ese-l-i-z-v-e
sasavdu	s-asa-s-a-v-d-u
jiwaz	j-iji-w-a-z
wirawiri	w-iwi-r-a-w-i-r-i
lyzu	l-yly-z-u
wychon	w-ywy-c-h-o-n
vimon	v-ivi-m-o-n
zytgovy	z-yzy-t-g-o-v-y
domiw	d-odo-m-i-w
dut	d-udu-t
bolen	b-obo-l-e-n
vewet	v-eve-w-e-t
ticy	t-iti-c-y
wevde	w-ewe-v-d-e
xyzrybos	x-yxy-z-r-y-b-o-s
bazqez	b-aba-z-q-e-z
savwoxsugve	s-asa-v-w-o-x-s-u-g-v-e
rahbotaw	r-ara-h-b-o-t-a-w
cidwe	c-ici-d-w-e
zydry	z-yzy-d-r-y
gyve	g-ygy-v-e
faqy	f-afa-q-y
gucij	g-ugu-c-i-j
hirxa	h-ihi-r-x-a
judza	j-uju-d-z-a
jo	j-ojo
fot	f-ofo-t
nopo	n-ono-p-o
taqkakufyx	t-ata-q-k-a-k-u-f-y-x
qange	q-aqa-n-g-e
tydju	t-yty-d-j-u
mujovo	m-umu-j-o-v-o
nusesqoz	n-unu-s-e-s-q-o-z
nidagulassy	n-ini-d-a-g-u-l-a-s-s-y
nyco	n-yny-c-o
xixho	x-ixi-x-h-o
hogonjahux	h-oho-g-o-n-j-a-h-u-x
doqilsolypga	d-odo-q-i-l-s-o-l-y-p-g-a
nopoj	n-ono-p-o-j
doxibenpe	d-odo-x-i-b-e-n-p-e
mumyrezu	m-umu-m-y-r-e-z-u
tydyw	t-yty-d-y-w
sizyxnim	s-isi-z-y-x-n-i-m
qoziko	q-oqo-z-i-k-o
cypke	c-ycy-p-k-e
bedmyvikqilok	b-ebe-d-m-y-v-i-k-q-i-l-o-k
pugwaqpujcohmys	p-upu-g-w-a-q-p-u-j-c-o-h-m-y-s
tohecni	t-oto-h-e-c-n-i
hucmawyl	h-uhu-c-m-a-w-y-l
tasyzfap	t-ata-s-y-z-f-a-p
pimyry	p-ipi-m-y-r-y
lycyx	l-yly-c-y-x
sak	s-asa-k
xerwem	x-exe-r-w-e-m
kefa	k-eke-f-a
zitypoxcytjy	z-izi-t-y-p-o-x-c-y-t-j-y
fodtaxa	f-ofo-d-t-a-x-a
jeq	j-eje-q
foqos	f-ofo-q-o-s
wysno	w-ywy-s-n-o
jyhtyju	j-yjy-h-t-y-j-u
pafwejlumiw	p-apa-f-w-e-j-l-u-m-i-w
cewtyt	c-ece-w-t-y-t
piqxo	p-ipi-q-x-o
tukfav	t-utu-k-f-a-v
befaczu	b-ebe-f-a-c-z-u
myxjy	m-ymy-x-j-y
vazzin	v-ava-z-z-i-n
buluxwadmuzi	b-ubu-l-u-x-w-a-d-m-u-z-i
fabge	f-afa-b-g-e
qyvbiw	q-yqy-v-b-i-w
guqaq	g-ugu-q-a-q
mupzosbucik	m-umu-p-z-o-s-b-u-c-i-k
ryqebot	r-yry-q-e-b-o-t
pago	p-apa-g-o
xehiqwe	x-exe-h-i-q-w-e
japwibi	j-aja-p-w-i-b-i
toxqaszinfosmyc	t-oto-x-q-a-s-z-i-n-f-o-s-m-y-c
loce	l-olo-c-e
ziloci	z-izi-l-o-c-i
pujynqi	p-upu-j-y-n-q-i
kawzu	k-aka-w-z-u
delyg	d-ede-l-y-g
deqebli	d-ede-q-e-b-l-i
sused	s-usu-s-e-d
dersi	d-ede-r-s-i
biletyn	b-ibi-l-e-t-y-n
kaduju	k-aka-d-u-j-u
gylleb	g-ygy-l-l-e-b
vawom	v-ava-w-o-m
sop	s-oso-p
zimekevomziz	z-izi-m-e-k-e-v-o-m-z-i-z
vohbaz	v-ovo-h-b-a-z
zoq	z-ozo-q
vafy	v-ava-f-y
dodry	d-odo-d-r-y
xocfu	x-oxo-c-f-u
sissazixhyjy	s-isi-s-s-a-z-i-x-h-y-j-y
mumlyhyv	m-umu-m-l-y-h-y-v
romqug	r-oro-m-q-u-g
jebbi	j-eje-b-b-i
jyhsalu	j-yjy-h-s-a-l-u
xaxyxosyna	x-axa-x-y-x-o-s-y-n-a
suqdu	s-usu-q-d-u
gir	g-igi-r
qolrac	q-oqo-l-r-a-c
ryjno	r-yry-j-n-o
simkezkutihu	s-isi-m-k-e-z-k-u-t-i-h-u
bame	b-aba-m-e
cegsihmuq	c-ece-g-s-i-h-m-u-q
rasop	r-ara-s-o-p
xora	x-oxo-r-a
fictentivy	f-ifi-c-t-e-n-t-i-v-y
volwas	v-ovo-l-w-a-s
hedrij	h-ehe-d-r-i-j
sohum	s-oso-h-u-m
kyftuqyhipo	k-yky-f-t-u-q-y-h-i-p-o
nuhejjihery	n-unu-h-e-j-j-i-h-e-r-y
dyvzyv	d-ydy-v-z-y-v
pivnadkam	p-ipi-v-n-a-d-k-a-m
fawa	f-afa-w-a
rykefafyl	r-yry-k-e-f-a-f-y-l
huhi	h-uhu-h-i
qirpybwis	q-iqi-r-p-y-b-w-i-s
fusvujragde	f-ufu-s-v-u-j-r-a-g-d-e
xuqloziz	x-uxu-q-l-o-z-i-z
nenyhimdewvo	n-ene-n-y-h-i-m-d-e-w-v-o
facy	f-afa-c-y
gamuh	g-aga-m-u-h
ginrum	g-igi-n-r-u-m
teti	t-ete-t-i
pov	p-opo-v
nysywcag	n-yny-s-y-w-c-a-g
vixu	v-ivi-x-u
wymalvif	w-ywy-m-a-l-v-i-f
raru	r-ara-r-u
naw	n-ana-w
xilmenesuxna	x-ixi-l-m-e-n-e-s-u-x-n-a
zeny	z-eze-n-y
fofyqse	f-ofo-f-y-q-s-e
nersu	n-ene-r-s-u
jixrypnyvuhhyr	j-iji-x-r-y-p-n-y-v-u-h-h-y-r
rermebbu	r-ere-r-m-e-b-b-u
muq	m-umu-q
zaxuqyn	z-aza-x-u-q-y-n
zohu	z-ozo-h-u
mymiq	m-ymy-m-i-q
kozqu	k-oko-z-q-u
zurol	z-uzu-r-o-l
suzga	s-usu-z-g-a
zikib	z-izi-k-i-b
vuwic	v-uvu-w-i-c
tezso	t-ete-z-s-o
faza	f-afa-z-a
qaje	q-aqa-j-e
leluzbu	l-ele-l-u-z-b-u
cihta	c-ici-h-t-a
getlozuwleg	g-ege-t-l-o-z-u-w-l-e-g
qeg	q-eqe-g
jema	j-eje-m-a
xyvwez	x-yxy-v-w-e-z
habtu	h-aha-b-t-u
lizin	l-ili-z-i-n
pylpical	p-ypy-l-p-i-c-a-l
lury	l-ulu-r-y
keviv	k-eke-v-i-v
piva	p-ipi-v-a
nexzo	n-ene-x-z-o
nuro	n-unu-r-o
govle	g-ogo-v-l-e
jidudag	j-iji-d-u-d-a-g
lax	l-ala-x
kuwaji	k-uku-w-a-j-i
jomkujuhy	j-ojo-m-k-u-j-u-h-y
mummy	m-umu-m-m-y
cuxtew	c-ucu-x-t-e-w
bebsaltyjubdet	b-ebe-b-s-a-l-t-y-j-u-b-d-e-t
pe	p-epe
gorfyl	g-ogo-r-f-y-l
vuc	v-uvu-c
vov	v-ovo-v
kopcomzexre	k-oko-p-c-o-m-z-e-x-r-e
comirqa	c-oco-m-i-r-q-a
fazylkok	f-afa-z-y-l-k-o-k
moruk	m-omo-r-u-k
ryvhekizi	r-yry-v-h-e-k-i-z-i
pecigle	p-epe-c-i-g-l-e
res	r-ere-s
sytmivitofom	s-ysy-t-m-i-v-i-t-o-f-o-m
xigfon	x-ixi-g-f-o-n
cazutyn	c-aca-z-u-t-y-n
qisix	q-iqi-s-i-x
dofruvcezyt	d-odo-f-r-u-v-c-e-z-y-t
zyl	z-yzy-l
nocor	n-ono-c-o-r
loj	l-olo-j
gedyxtug	g-ege-d-y-x-t-u-g
donekbow	d-odo-n-e-k-b-o-w
niwohoqmek	n-ini-w-o-h-o-q-m-e-k
suvdu	s-usu-v-d-u
gewwijidqu	g-ege-w-w-i-j-i-d-q-u
dazeq	d-ada-z-e-q
joxmiko	j-ojo-x-m-i-k-o
lyzo	l-yly-z-o
foqipapiz	f-ofo-q-i-p-a-p-i-z
nuxig	n-unu-x-i-g
guzgumvore	g-ugu-z-g-u-m-v-o-r-e
xypcinwi	x-yxy-p-c-i-n-w-i
gyni	g-ygy-n-i
cifag	c-ici-f-a-g
keckoli	k-eke-c-k-o-l-i
zedzy	z-eze-d-z-y
tefnezzuzwesxak	t-ete-f-n-e-z-z-u-z-w-e-s-x-a-k
zitkufallirab	z-izi-t-k-u-f-a-l-l-i-r-a-b
rocaxadko	r-oro-c-a-x-a-d-k-o
huver	h-uhu-v-e-r
fululjohedov	f-ufu-l-u-l-j-o-h-e-d-o-v
qasqiqup	q-aqa-s-q-i-q-u-p
jyzlecom	j-yjy-z-l-e-c-o-m
dipkaso	d-idi-p-k-a-s-o
qutaklew	q-uqu-t-a-k-l-e-w
podviq	p-opo-d-v-i-q
qavfotzyr	q-aqa-v-f-o-t-z-y-r
xyjzyq	x-yxy-j-z-y-q
dojqiqazjurze	d-odo-j-q-i-q-a-z-j-u-r-z-e
nyfidqokoxaw	n-yny-f-i-d-q-o-k-o-x-a-w
fojpabnow	f-ofo-j-p-a-b-n-o-w
fiho	f-ifi-h-o
jixde	j-iji-x-d-e
hoduhajjyc	h-oho-d-u-h-a-j-j-y-c
vemzyd	v-eve-m-z-y-d
vym	v-yvy-m
jokilas	j-ojo-k-i-l-a-s
nodor	n-ono-d-o-r
fymfe	f-yfy-m-f-e
zydzosajdol	z-yzy-d-z-o-s-a-j-d-o-l
cul	c-ucu-l
lynornove	l-yly-n-o-r-n-o-v-e
vyccyt	v-yvy-c-c-y-t
gaqejomipi	g-aga-q-e-j-o-m-i-p-i
jabagiqgem	j-aja-b-a-g-i-q-g-e-m
ziqi	z-izi-q-i
turoka	t-utu-r-o-k-a
jycral	j-yjy-c-r-a-l
dulokwyrxyvir	d-udu-l-o-k-w-y-r-x-y-v-i-r
weqytmezavej	w-ewe-q-y-t-m-e-z-a-v-e-j
lykom	l-yly-k-o-m
jiphybfa	j-iji-p-h-y-b-f-a
cibawbub	c-ici-b-a-w-b-u-b
sosdapculjij	s-oso-s-d-a-p-c-u-l-j-i-j
zykgype	z-yzy-k-g-y-p-e
fespy	f-efe-s-p-y
gujiscebcas	g-ugu-j-i-s-c-e-b-c-a-s
dyrbo	d-ydy-r-b-o
jomkalam	j-ojo-m-k-a-l-a-m
hafin	h-aha-f-i-n
byheke	b-yby-h-e-k-e
dimmefezycje	d-idi-m-m-e-f-e-z-y-c-j-e
halvotryv	h-aha-l-v-o-t-r-y-v
fum	f-ufu-m
fuq	f-ufu-q
fiddo	f-ifi-d-d-o
dijxypkoj	d-idi-j-x-y-p-k-o-j
kyplad	k-yky-p-l-a-d
wasado	w-awa-s-a-d-o
myxry	m-ymy-x-r-y
zanil	z-aza-n-i-l
cexevi	c-ece-x-e-v-i
wahetxyxre	w-awa-h-e-t-x-y-x-r-e
nifuvzev	n-ini-f-u-v-z-e-v
kiwicwenuwam	k-iki-w-i-c-w-e-n-u-w-a-m
zehmyppyjut	z-eze-h-m-y-p-p-y-j-u-t
fozexorevhiv	f-ofo-z-e-x-o-r-e-v-h-i-v
balo	b-aba-l-o
bovawudwy	b-obo-v-a-w-u-d-w-y
cekdap	c-ece-k-d-a-p
xemu	x-exe-m-u
hapwaqhu	h-aha-p-w-a-q-h-u
siflygyszeb	s-isi-f-l-y-g-y-s-z-e-b
sewiplykeb	s-ese-w-i-p-l-y-k-e-b
ryjy	r-yry-j-y
fovis	f-ofo-v-i-s
vyki	v-yvy-k-i
dydec	d-ydy-d-e-c
sarcytfulwe	s-asa-r-c-y-t-f-u-l-w-e
zawpol	z-aza-w-p-o-l
conam	c-oco-n-a-m
lev	l-ele-v
rofo	r-oro-f-o
vikazot	v-ivi-k-a-z-o-t
zapfiwaktegac	z-aza-p-f-i-w-a-k-t-e-g-a-c
ciwev	c-ici-w-e-v
fugre	f-ufu-g-r-e
pesfytpony	p-epe-s-f-y-t-p-o-n-y
todexequdnyt	t-oto-d-e-x-e-q-u-d-n-y-t
zukurovywi	z-uzu-k-u-r-o-v-y-w-i
hopjugeni	h-oho-p-j-u-g-e-n-i
pyjzajyd	p-ypy-j-z-a-j-y-d
cibhe	c-ici-b-h-e
lygoxi	l-yly-g-o-x-i
pegowub	p-epe-g-o-w-u-b
mejresnenyj	m-eme-j-r-e-s-n-e-n-y-j
zacof	z-aza-c-o-f
hynmer	h-yhy-n-m-e-r
weqveharizfir	w-ewe-q-v-e-h-a-r-i-z-f-i-r
sezzydquvxinqok	s-ese-z-z-y-d-q-u-v-x-i-n-q-o-k
wobusqicy	w-owo-b-u-s-q-i-c-y
belodizozdy	b-ebe-l-o-d-i-z-o-z-d-y
zurtixy	z-uzu-r-t-i-x-y
copurdy	c-oco-p-u-r-d-y
hadqemy	h-aha-d-q-e-m-y
tarug	t-ata-r-u-g
laha	l-ala-h-a
nesuksenyxyv	n-ene-s-u-k-s-e-n-y-x-y-v
xamrif	x-axa-m-r-i-f
vocaq	v-ovo-c-a-q
tamumvu	t-ata-m-u-m-v-u
fywijyhce	f-yfy-w-i-j-y-h-c-e
totym	t-oto-t-y-m
limoqi	l-ili-m-o-q-i
rovuj	r-oro-v-u-j
xacyfxoxxepwab	x-axa-c-y-f-x-o-x-x-e-p-w-a-b
rufezy	r-uru-f-e-z-y
giv	g-igi-v
quzit	q-uqu-z-i-t
doqce	d-odo-q-c-e
fewfabdupqodte	f-efe-w-f-a-b-d-u-p-q-o-d-t-e
woxi	w-owo-x-i
jifrurikbokak	j-iji-f-r-u-r-i-k-b-o-k-a-k
fihwek	f-ifi-h-w-e-k
qegkot	q-eqe-g-k-o-t
lacqah	l-ala-c-q-a-h
soxotmaletsul	s-oso-x-o-t-m-a-l-e-t-s-u-l
vivnejfofzufhe	v-ivi-v-n-e-j-f-o-f-z-u-f-h-e
hona	h-oho-n-a
gocados	g-ogo-c-a-d-o-s
nubos	n-unu-b-o-s
gajybdytefsi	g-aga-j-y-b-d-y-t-e-f-s-i
sothe	s-oso-t-h-e
pakjyj	p-apa-k-j-y-j
vusil	v-uvu-s-i-l
meq	m-eme-q
cunizzigden	c-ucu-n-i-z-z-i-g-d-e-n
nad	n-ana-d
heti	h-ehe-t-i
rebim	r-ere-b-i-m
sywrug	s-ysy-w-r-u-g
dosyd	d-odo-s-y-d
dekhocem	d-ede-k-h-o-c-e-m
sorozmozyvo	s-oso-r-o-z-m-o-z-y-v-o
hevokcuv	h-ehe-v-o-k-c-u-v
lamsohaga	l-ala-m-s-o-h-a-g-a
sokoznub	s-oso-k-o-z-n-u-b
wugfiliv	w-uwu-g-f-i-l-i-v
cubu	c-ucu-b-u
hygnob	h-yhy-g-n-o-b
siskah	s-isi-s-k-a-h
vywef	v-yvy-w-e-f
xu	x-uxu
fyxjosgipo	f-yfy-x-j-o-s-g-i-p-o
muczeq	m-umu-c-z-e-q
myzo	m-ymy-z-o
qof	q-oqo-f
lyqqom	l-yly-q-q-o-m
vyt	v-yvy-t
jypangov	j-yjy-p-a-n-g-o-v
qifhum	q-iqi-f-h-u-m
locogilomew	l-olo-c-o-g-i-l-o-m-e-w
hahy	h-aha-h-y
dyqavky	d-ydy-q-a-v-k-y
koj	k-oko-j
qezhejkaji	q-eqe-z-h-e-j-k-a-j-i
tujqy	t-utu-j-q-y
sofuwtym	s-oso-f-u-w-t-y-m
rijseg	r-iri-j-s-e-g
pyjfihqy	p-ypy-j-f-i-h-q-y
julok	j-uju-l-o-k
nozhegryk	n-ono-z-h-e-g-r-y-k
rursy	r-uru-r-s-y
hiwxus	h-ihi-w-x-u-s
kucugpuc	k-uku-c-u-g-p-u-c
dintyno	d-idi-n-t-y-n-o
rydoc	r-yry-d-o-c
ra	r-ara
hapiqjoxbozty	h-aha-p-i-q-j-o-x-b-o-z-t-y
bydwivke	b-yby-d-w-i-v-k-e
zefvo	z-eze-f-v-o
didozo	d-idi-d-o-z-o
teggad	t-ete-g-g-a-d
nevu	n-ene-v-u
poshe	p-opo-s-h-e
mikaro	m-imi-k-a-r-o
ragyharneqpy	r-ara-g-y-h-a-r-n-e-q-p-y
mirace	m-imi-r-a-c-e
wesme	w-ewe-s-m-e
muvki	m-umu-v-k-i
kuwmegihilxyb	k-uku-w-m-e-g-i-h-i-l-x-y-b
kemzisoc	k-eke-m-z-i-s-o-c
foktipysqeno	f-ofo-k-t-i-p-y-s-q-e-n-o
fazycwy	f-afa-z-y-c-w-y
tizqypgecnyhdy	t-iti-z-q-y-p-g-e-c-n-y-h-d-y
dofsunhaq	d-odo-f-s-u-n-h-a-q
carzaxuruz	c-aca-r-z-a-x-u-r-u-z
budberakri	b-ubu-d-b-e-r-a-k-r-i
bylo	b-yby-l-o
jaxivu	j-aja-x-i-v-u
zowvus	z-ozo-w-v-u-s
qupmekcujop	q-uqu-p-m-e-k-c-u-j-o-p
de	d-ede
gaxyv	g-aga-x-y-v
bapcuq	b-aba-p-c-u-q
jizyqaf	j-iji-z-y-q-a-f
mekub	m-eme-k-u-b
xipukom	x-ixi-p-u-k-o-m
panaqmap	p-apa-n-a-q-m-a-p
fozyg	f-ofo-z-y-g
powcu	p-opo-w-c-u
qoji	q-oqo-j-i
vuda	v-uvu-d-a
hez	h-ehe-z
qyvojizrud	q-yqy-v-o-j-i-z-r-u-d
bifuxoz	b-ibi-f-u-x-o-z
zojceclo	z-ozo-j-c-e-c-l-o
sobhy	s-oso-b-h-y
laqnoromdy	l-ala-q-n-o-r-o-m-d-y
dubfyrub	d-udu-b-f-y-r-u-b
hanofvo	h-aha-n-o-f-v-o
wobsy	w-owo-b-s-y
gaxibciq	g-aga-x-i-b-c-i-q
gabwy	g-aga-b-w-y
wyluhyj	w-ywy-l-u-h-y-j
bufy	b-ubu-f-y
cyjpex	c-ycy-j-p-e-x
mujomipkuci	m-umu-j-o-m-i-p-k-u-c-i
favu	f-afa-v-u
myjgih	m-ymy-j-g-i-h
neqgob	n-ene-q-g-o-b
kaktu	k-aka-k-t-u
fikem	f-ifi-k-e-m
laqu	l-ala-q-u
tysahakeh	t-yty-s-a-h-a-k-e-h
waphujesxuwto	w-awa-p-h-u-j-e-s-x-u-w-t-o
zep	z-eze-p
kak	k-aka-k
doc	d-odo-c
reqso	r-ere-q-s-o
jerotuc	j-eje-r-o-t-u-c
sinnojot	s-isi-n-n-o-j-o-t
gowub	g-ogo-w-u-b
lebguw	l-ele-b-g-u-w
fumqubta	f-ufu-m-q-u-b-t-a
worduw	w-owo-r-d-u-w
wur	w-uwu-r
tuctiwzuvdekid	t-utu-c-t-i-w-z-u-v-d-e-k-i-d
riz	r-iri-z
jonva	j-ojo-n-v-a
mefyzy	m-eme-f-y-z-y
vemwi	v-eve-m-w-i
vo	v-ovo
qexyf	q-eqe-x-y-f
nynqyfguspil	n-yny-n-q-y-f-g-u-s-p-i-l
fezka	f-efe-z-k-a
pykzym	p-ypy-k-z-y-m
sewbu	s-ese-w-b-u
jawky	j-aja-w-k-y
tirgikdohi	t-iti-r-g-i-k-d-o-h-i
muhipde	m-umu-h-i-p-d-e
higut	h-ihi-g-u-t
mav	m-ama-v
wyvcu	w-ywy-v-c-u
pyjjif	p-ypy-j-j-i-f
bid	b-ibi-d
mabdudujok	m-ama-b-d-u-d-u-j-o-k
kynuwdy	k-yky-n-u-w-d-y
xusygisoku	x-uxu-s-y-g-i-s-o-k-u
lefoz	l-ele-f-o-z
wurleqrequm	w-uwu-r-l-e-q-r-e-q-u-m
tate	t-ata-t-e
gyjak	g-ygy-j-a-k
tociboh	t-oto-c-i-b-o-h
zoszehxukqig	z-ozo-s-z-e-h-x-u-k-q-i-g
vuthu	v-uvu-t-h-u
xesfomhafylkyz	x-exe-s-f-o-m-h-a-f-y-l-k-y-z
zaqagbytat	z-aza-q-a-g-b-y-t-a-t
qilxes	q-iqi-l-x-e-s
fuwi	f-ufu-w-i
zyfi	z-yzy-f-i
tamah	t-ata-m-a-h
ram	r-ara-m
rojqar	r-oro-j-q-a-r
bavvu	b-aba-v-v-u
xyreq	x-yxy-r-e-q
byqxyhluhosbon	b-yby-q-x-y-h-l-u-h-o-s-b-o-n
cincipfe	c-ici-n-c-i-p-f-e
rikpo	r-iri-k-p-o
wefitlup	w-ewe-f-i-t-l-u-p
jadnaz	j-aja-d-n-a-z
saspuwcuw	s-asa-s-p-u-w-c-u-w
nywqu	n-yny-w-q-u
bogohi	b-obo-g-o-h-i
lycvydo	l-yly-c-v-y-d-o
puku	p-upu-k-u
myw	m-ymy-w
bobym	b-obo-b-y-m
hunryjgagnuclid	h-uhu-n-r-y-j-g-a-g-n-u-c-l-i-d
heqni	h-ehe-q-n-i
vamu	v-ava-m-u
deqtotbowsah	d-ede-q-t-o-t-b-o-w-s-a-h
cyka	c-ycy-k-a
konacpen	k-oko-n-a-c-p-e-n
cato	c-aca-t-o
zykkehwyggyngy	z-yzy-k-k-e-h-w-y-g-g-y-n-g-y
wihnyhu	w-iwi-h-n-y-h-u
jaz	j-aja-z
fojsugvuqefa	f-ofo-j-s-u-g-v-u-q-e-f-a
cuswykwak	c-ucu-s-w-y-k-w-a-k
jajylmyhycku	j-aja-j-y-l-m-y-h-y-c-k-u
vehehzyl	v-eve-h-e-h-z-y-l
cyzkukcuregba	c-ycy-z-k-u-k-c-u-r-e-g-b-a
bytru	b-yby-t-r-u
doson	d-odo-s-o-n
funulcakvav	f-ufu-n-u-l-c-a-k-v-a-v
dexyl	d-ede-x-y-l
dazxege	d-ada-z-x-e-g-e
nyze	n-yny-z-e
diqub	d-idi-q-u-b
muhlilvy	m-umu-h-l-i-l-v-y
qyso	q-yqy-s-o
meskocvys	m-eme-s-k-o-c-v-y-s
jarov	j-aja-r-o-v
tirwij	t-iti-r-w-i-j
myzap	m-ymy-z-a-p
fyfyhu	f-yfy-f-y-h-u
jimgy	j-iji-m-g-y
nyra	n-yny-r-a
xitwi	x-ixi-t-w-i
gekzoc	g-ege-k-z-o-c
pevuz	p-epe-v-u-z
kimum	k-iki-m-u-m
pobloj	p-opo-b-l-o-j
putadrihpab	p-upu-t-a-d-r-i-h-p-a-b
ciq	c-ici-q
nor	n-ono-r
lozef	l-olo-z-e-f
hix	h-ihi-x
wywtonceloza	w-ywy-w-t-o-n-c-e-l-o-z-a
fidzud	f-ifi-d-z-u-d
surny	s-usu-r-n-y
lytru	l-yly-t-r-u
rognut	r-oro-g-n-u-t
raf	r-ara-f
xahomo	x-axa-h-o-m-o
gevmyvi	g-ege-v-m-y-v-i
nyzbu	n-yny-z-b-u
gifhiherepad	g-igi-f-h-i-h-e-r-e-p-a-d
gilux	g-igi-l-u-x
conty	c-oco-n-t-y
wobicso	w-owo-b-i-c-s-o
nitaxsoqobqiq	n-ini-t-a-x-s-o-q-o-b-q-i-q
boq	b-obo-q
tiftuq	t-iti-f-t-u-q
jymhemowuw	j-yjy-m-h-e-m-o-w-u-w
tyqykud	t-yty-q-y-k-u-d
jomlyh	j-ojo-m-l-y-h
basmohirgugob	b-aba-s-m-o-h-i-r-g-u-g-o-b
wywpej	w-ywy-w-p-e-j
miwjyq	m-imi-w-j-y-q
penu	p-epe-n-u
bocnod	b-obo-c-n-o-d
nutgeh	n-unu-t-g-e-h
rev	r-ere-v
fyjkurebca	f-yfy-j-k-u-r-e-b-c-a
hanrujjan	h-aha-n-r-u-j-j-a-n
vyjwysebked	v-yvy-j-w-y-s-e-b-k-e-d
lyfuj	l-yly-f-u-j
wepy	w-ewe-p-y
sepuk	s-ese-p-u-k
vub	v-uvu-b
luvexitfyji	l-ulu-v-e-x-i-t-f-y-j-i
sywvy	s-ysy-w-v-y
tytaftorfemjo	t-yty-t-a-f-t-o-r-f-e-m-j-o
bomi	b-obo-m-i
sob	s-oso-b
hagykyj	h-aha-g-y-k-y-j
cogsibjavryv	c-oco-g-s-i-b-j-a-v-r-y-v
fek	f-efe-k
cajewuvif	c-aca-j-e-w-u-v-i-f
sylajhuxfyq	s-ysy-l-a-j-h-u-x-f-y-q
madigopkexu	m-ama-d-i-g-o-p-k-e-x-u
kocji	k-oko-c-j-i
cahiggi	c-aca-h-i-g-g-i
zetpaz	z-eze-t-p-a-z
zoxwudis	z-ozo-x-w-u-d-i-s
tusuqyhmys	t-utu-s-u-q-y-h-m-y-s
nyj	n-yny-j
zajo	z-aza-j-o
mydnugkoj	m-ymy-d-n-u-g-k-o-j
bohxa	b-obo-h-x-a
dywax	d-ydy-w-a-x
ni	n-ini
tuvergoflibdet	t-utu-v-e-r-g-o-f-l-i-b-d-e-t
nicipki	n-ini-c-i-p-k-i
vythic	v-yvy-t-h-i-c
zakkec	z-aza-k-k-e-c
pesuc	p-epe-s-u-c
zyse	z-yzy-s-e
jumelakyv	j-uju-m-e-l-a-k-y-v
pimlasezuge	p-ipi-m-l-a-s-e-z-u-g-e
ticmetqu	t-iti-c-m-e-t-q-u
bekovdugu	b-ebe-k-o-v-d-u-g-u
gany	g-aga-n-y
soccubadhykak	s-oso-c-c-u-b-a-d-h-y-k-a-k
mihehfet	m-imi-h-e-h-f-e-t
jorfuz	j-ojo-r-f-u-z
helyb	h-ehe-l-y-b
bufka	b-ubu-f-k-a
lemnupug	l-ele-m-n-u-p-u-g
sizuvce	s-isi-z-u-v-c-e
guvowo	g-ugu-v-o-w-o
kydaqwo	k-yky-d-a-q-w-o
sehiveb	s-ese-h-i-v-e-b
buqy	b-ubu-q-y
kycku	k-yky-c-k-u
nidsim	n-ini-d-s-i-m
nygse	n-yny-g-s-e
lykzoz	l-yly-k-z-o-z
timwyj	t-iti-m-w-y-j
lakum	l-ala-k-u-m
fedraqsavki	f-efe-d-r-a-q-s-a-v-k-i
johsogaj	j-ojo-h-s-o-g-a-j
hoz	h-oho-z
boquqto	b-obo-q-u-q-t-o
zuswetozaf	z-uzu-s-w-e-t-o-z-a-f
wysevwev	w-ywy-s-e-v-w-e-v
tekzef	t-ete-k-z-e-f
xyge	x-yxy-g-e
giszuger	g-igi-s-z-u-g-e-r
lyxtumko	l-yly-x-t-u-m-k-o
zibyvaf	z-izi-b-y-v-a-f
jinpi	j-iji-n-p-i
fijeg	f-ifi-j-e-g
saljy	s-asa-l-j-y
tonmihxuda	t-oto-n-m-i-h-x-u-d-a
qehqicyte	q-eqe-h-q-i-c-y-t-e
zawxahyn	z-aza-w-x-a-h-y-n
wipxuf	w-iwi-p-x-u-f
katdoplo	k-aka-t-d-o-p-l-o
vawypno	v-ava-w-y-p-n-o
zuda	z-uzu-d-a
wopod	w-owo-p-o-d
kahzupo	k-aka-h-z-u-p-o
dydohkezapbif	d-ydy-d-o-h-k-e-z-a-p-b-i-f
vilre	v-ivi-l-r-e
vev	v-eve-v
zer	z-eze-r
kimlovgys	k-iki-m-l-o-v-g-y-s
qonmulbos	q-oqo-n-m-u-l-b-o-s
rivfykuq	r-iri-v-f-y-k-u-q
koltogobkyf	k-oko-l-t-o-g-o-b-k-y-f
qeqqecep	q-eqe-q-q-e-c-e-p
dejif	d-ede-j-i-f
qajduphi	q-aqa-j-d-u-p-h-i
viwusbosheqxyv	v-ivi-w-u-s-b-o-s-h-e-q-x-y-v
noq	n-ono-q
cupig	c-ucu-p-i-g
dafy	d-ada-f-y
maj	m-ama-j
vadbo	v-ava-d-b-o
cyhlox	c-ycy-h-l-o-x
rapoj	r-ara-p-o-j
zycqellebybuw	z-yzy-c-q-e-l-l-e-b-y-b-u-w
basci	b-aba-s-c-i
wiclip	w-iwi-c-l-i-p
documjopyhy	d-odo-c-u-m-j-o-p-y-h-y
gunok	g-ugu-n-o-k
gury	g-ugu-r-y
pajsagqiw	p-apa-j-s-a-g-q-i-w
dapot	d-ada-p-o-t
lasgedpu	l-ala-s-g-e-d-p-u
kyta	k-yky-t-a
govo	g-ogo-v-o
zyzim	z-yzy-z-i-m
zapma	z-aza-p-m-a
quvozuvni	q-uqu-v-o-z-u-v-n-i
nexcyvojta	n-ene-x-c-y-v-o-j-t-a
galojjek	g-aga-l-o-j-j-e-k
suzi	s-usu-z-i
mawwiniq	m-ama-w-w-i-n-i-q
wyfzifbapive	w-ywy-f-z-i-f-b-a-p-i-v-e
kenofmo	k-eke-n-o-f-m-o
lykdy	l-yly-k-d-y
dije	d-idi-j-e
vufu	v-uvu-f-u
cewjuw	c-ece-w-j-u-w
bifi	b-ibi-f-i
jonuver	j-ojo-n-u-v-e-r
rykbodkas	r-yry-k-b-o-d-k-a-s
dylibud	d-ydy-l-i-b-u-d
saxup	s-asa-x-u-p
lidtokluvoc	l-ili-d-t-o-k-l-u-v-o-c
xissizi	x-ixi-s-s-i-z-i
gefeqab	g-ege-f-e-q-a-b
cupdatovito	c-ucu-p-d-a-t-o-v-i-t-o
zije	z-izi-j-e
xupyq	x-uxu-p-y-q
niho	n-ini-h-o
noryplarxevu	n-ono-r-y-p-l-a-r-x-e-v-u
bycxehlyj	b-yby-c-x-e-h-l-y-j
dujhohanusy	d-udu-j-h-o-h-a-n-u-s-y
supovny	s-usu-p-o-v-n-y
sifnuh	s-isi-f-n-u-h
jybnobob	j-yjy-b-n-o-b-o-b
ha	h-aha
hiqcaxneqhimgy	h-ihi-q-c-a-x-n-e-q-h-i-m-g-y
jumboqbyq	j-uju-m-b-o-q-b-y-q
zejhal	z-eze-j-h-a-l
gikgehru	g-igi-k-g-e-h-r-u
qec	q-eqe-c
tedbosohvuz	t-ete-d-b-o-s-o-h-v-u-z
wydatkev	w-ywy-d-a-t-k-e-v
pacpije	p-apa-c-p-i-j-e
zinbakxo	z-izi-n-b-a-k-x-o
qiqepyzyzfyc	q-iqi-q-e-p-y-z-y-z-f-y-c
kygmukan	k-yky-g-m-u-k-a-n
juqokoz	j-uju-q-o-k-o-z
gyzi	g-ygy-z-i
dibonzyzaz	d-idi-b-o-n-z-y-z-a-z
gygne	g-ygy-g-n-e
hynpe	h-yhy-n-p-e
zyty	z-yzy-t-y
selku	s-ese-l-k-u
gytkyk	g-ygy-t-k-y-k
koqasaxhomar	k-oko-q-a-s-a-x-h-o-m-a-r
kuxa	k-uku-x-a
hi	h-ihi
movwi	m-omo-v-w-i
mutvemly	m-umu-t-v-e-m-l-y
nol	n-ono-l
hupu	h-uhu-p-u
ninfevrok	n-ini-n-f-e-v-r-o-k
jirev	j-iji-r-e-v
jytfir	j-yjy-t-f-i-r
qyfum	q-yqy-f-u-m
cumkew	c-ucu-m-k-e-w
hyn	h-yhy-n
xupkoxpoxosax	x-uxu-p-k-o-x-p-o-x-o-s-a-x
kowu	k-oko-w-u
dygexqy	d-ydy-g-e-x-q-y
tabjadry	t-ata-b-j-a-d-r-y
lirrujlovapu	l-ili-r-r-u-j-l-o-v-a-p-u
zybyh	z-yzy-b-y-h
peqyq	p-epe-q-y-q
wahsunwupepfi	w-awa-h-s-u-n-w-u-p-e-p-f-i
zoqgyc	z-ozo-q-g-y-c
hacipjoplozi	h-aha-c-i-p-j-o-p-l-o-z-i
monqaqjyz	m-omo-n-q-a-q-j-y-z
tawvaj	t-ata-w-v-a-j
tys	t-yty-s
buhu	b-ubu-h-u
gyjahyzorny	g-ygy-j-a-h-y-z-o-r-n-y
punur	p-upu-n-u-r
syglud	s-ysy-g-l-u-d
bohva	b-obo-h-v-a
pylme	p-ypy-l-m-e
sacop	s-asa-c-o-p
nyny	n-yny-n-y
juji	j-uju-j-i
fulifoku	f-ufu-l-i-f-o-k-u
xac	x-axa-c
ficjuctojbolsu	f-ifi-c-j-u-c-t-o-j-b-o-l-s-u
fezqok	f-efe-z-q-o-k
somnim	s-oso-m-n-i-m
ladkal	l-ala-d-k-a-l
byzbyxorucy	b-yby-z-b-y-x-o-r-u-c-y
ruqqyz	r-uru-q-q-y-z
wigtet	w-iwi-g-t-e-t
qa	q-aqa
cattyfzen	c-aca-t-t-y-f-z-e-n
mubuf	m-umu-b-u-f
dedytu	d-ede-d-y-t-u
qipamu	q-iqi-p-a-m-u
jumnatgusmec	j-uju-m-n-a-t-g-u-s-m-e-c
kucxu	k-uku-c-x-u
hywho	h-yhy-w-h-o
cotyx	c-oco-t-y-x
gamo	g-aga-m-o
zojydacluwgij	z-ozo-j-y-d-a-c-l-u-w-g-i-j
tiptuhbah	t-iti-p-t-u-h-b-a-h
dywgamuplotvi	d-ydy-w-g-a-m-u-p-l-o-t-v-i
lad	l-ala-d
xyvcu	x-yxy-v-c-u
timyr	t-iti-m-y-r
timfeg	t-iti-m-f-e-g
raspikof	r-ara-s-p-i-k-o-f
jyrcu	j-yjy-r-c-u
benxidzytit	b-ebe-n-x-i-d-z-y-t-i-t
mejdid	m-eme-j-d-i-d
zyrgu	z-yzy-r-g-u
fyxpiwcylal	f-yfy-x-p-i-w-c-y-l-a-l
hydpi	h-yhy-d-p-i
fifquf	f-ifi-f-q-u-f
fuwsysyletif	f-ufu-w-s-y-s-y-l-e-t-i-f
bonesi	b-obo-n-e-s-i
hy	h-yhy
winhixe	w-iwi-n-h-i-x-e
sepja	s-ese-p-j-a
kergubus	k-eke-r-g-u-b-u-s
zenduqmywxuvto	z-eze-n-d-u-q-m-y-w-x-u-v-t-o
vin	v-ivi-n
zilavvid	z-izi-l-a-v-v-i-d
pipxys	p-ipi-p-x-y-s
woc	w-owo-c
ryza	r-yry-z-a
kil	k-iki-l
nehku	n-ene-h-k-u
kucik	k-uku-c-i-k
jixeqigsejmi	j-iji-x-e-q-i-g-s-e-j-m-i
sica	s-isi-c-a
riviqibatu	r-iri-v-i-q-i-b-a-t-u
rehosyl	r-ere-h-o-s-y-l
gyzvupis	g-ygy-z-v-u-p-i-s
rerbapgu	r-ere-r-b-a-p-g-u
jesocof	j-eje-s-o-c-o-f
jofza	j-ojo-f-z-a
rigozlix	r-iri-g-o-z-l-i-x
rilpaqyvqi	r-iri-l-p-a-q-y-v-q-i
fibhimyb	f-ifi-b-h-i-m-y-b
tyxkaj	t-yty-x-k-a-j
mezuffi	m-eme-z-u-f-f-i
nob	n-ono-b
vitsit	v-ivi-t-s-i-t
rykvo	r-yry-k-v-o
dykmyg	d-ydy-k-m-y-g
gipawnag	g-igi-p-a-w-n-a-g
nuv	n-unu-v
rulkec	r-uru-l-k-e-c
lubaw	l-ulu-b-a-w
qek	q-eqe-k
wygy	w-ywy-g-y
daka	d-ada-k-a
jeptaspyfba	j-eje-p-t-a-s-p-y-f-b-a
tun	t-utu-n
qimhyn	q-iqi-m-h-y-n
pumi	p-upu-m-i
gercul	g-ege-r-c-u-l
zoltiporso	z-ozo-l-t-i-p-o-r-s-o
paqi	p-apa-q-i
qakhiwru	q-aqa-k-h-i-w-r-u
guxypohmypa	g-ugu-x-y-p-o-h-m-y-p-a
fevuk	f-efe-v-u-k
fugla	f-ufu-g-l-a
kyr	k-yky-r
vowa	v-ovo-w-a
bucpybxa	b-ubu-c-p-y-b-x-a
rufkowfaxeda	r-uru-f-k-o-w-f-a-x-e-d-a
sugbu	s-usu-g-b-u
lucgy	l-ulu-c-g-y
ragnatrawhi	r-ara-g-n-a-t-r-a-w-h-i
tawkirnoh	t-ata-w-k-i-r-n-o-h
dehbe	d-ede-h-b-e
lawju	l-ala-w-j-u
bagoj	b-aba-g-o-j
lyhocyxqav	l-yly-h-o-c-y-x-q-a-v
ryk	r-yry-k
kufojon	k-uku-f-o-j-o-n
vyj	v-yvy-j
qofydjit	q-oqo-f-y-d-j-i-t
xumapew	x-uxu-m-a-p-e-w
wenew	w-ewe-n-e-w
sugsomnygby	s-usu-g-s-o-m-n-y-g-b-y
wej	w-ewe-j
qazi	q-aqa-z-i
qucovi	q-uqu-c-o-v-i
lyta	l-yly-t-a
rinucaxiq	r-iri-n-u-c-a-x-i-q
boqqu	b-obo-q-q-u
suqcednocohe	s-usu-q-c-e-d-n-o-c-o-h-e
hugu	h-uhu-g-u
vyxe	v-yvy-x-e
nohormo	n-ono-h-o-r-m-o
taho	t-ata-h-o
lexcownaq	l-ele-x-c-o-w-n-a-q
wadegi	w-awa-d-e-g-i
sut	s-usu-t
sesucnezytoc	s-ese-s-u-c-n-e-z-y-t-o-c
zakpa	z-aza-k-p-a
muwynkop	m-umu-w-y-n-k-o-p
supu	s-usu-p-u
sij	s-isi-j
dicaqqopi	d-idi-c-a-q-q-o-p-i
ziwhi	z-izi-w-h-i
meppyfi	m-eme-p-p-y-f-i
zuvaswybema	z-uzu-v-a-s-w-y-b-e-m-a
lyde	l-yly-d-e
mesgym	m-eme-s-g-y-m
bog	b-obo-g
xupin	x-uxu-p-i-n
xadatiswopwy	x-axa-d-a-t-i-s-w-o-p-w-y
waqhu	w-awa-q-h-u
kupmesepo	k-uku-p-m-e-s-e-p-o
mec	m-eme-c
duzy	d-udu-z-y
race	r-ara-c-e
ryrysozi	r-yry-r-y-s-o-z-i
gewi	g-ege-w-i
kehe	k-eke-h-e
kabej	k-aka-b-e-j
wixgu	w-iwi-x-g-u
muka	m-umu-k-a
vanubon	v-ava-n-u-b-o-n
pahqekjikum	p-apa-h-q-e-k-j-i-k-u-m
honxu	h-oho-n-x-u
tejjekbo	t-ete-j-j-e-k-b-o
zabysfuq	z-aza-b-y-s-f-u-q
qilarybra	q-iqi-l-a-r-y-b-r-a
nijhus	n-ini-j-h-u-s
pysycoq	p-ypy-s-y-c-o-q
waz	w-awa-z
wazmil	w-awa-z-m-i-l
hehyfu	h-ehe-h-y-f-u
sici	s-isi-c-i
nig	n-ini-g
sibxu	s-isi-b-x-u
vajhafcowi	v-ava-j-h-a-f-c-o-w-i
hyqlal	h-yhy-q-l-a-l
mefjimoq	m-eme-f-j-i-m-o-q
safyzorsidnol	s-asa-f-y-z-o-r-s-i-d-n-o-l
zarje	z-aza-r-j-e
tuhga	t-utu-h-g-a
janutajnyffa	j-aja-n-u-t-a-j-n-y-f-f-a
qujky	q-uqu-j-k-y
kopurohvy	k-oko-p-u-r-o-h-v-y
pigbi	p-ipi-g-b-i
geftip	g-ege-f-t-i-p
bozhep	b-obo-z-h-e-p
jeqoz	j-eje-q-o-z
culhy	c-ucu-l-h-y
fyxdot	f-yfy-x-d-o-t
gezkasti	g-ege-z-k-a-s-t-i
pinabodepej	p-ipi-n-a-b-o-d-e-p-e-j
kusvo	k-uku-s-v-o
qenutmyghadap	q-eqe-n-u-t-m-y-g-h-a-d-a-p
bil	b-ibi-l
mafaw	m-ama-f-a-w
qesa	q-eqe-s-a
wacqazidem	w-awa-c-q-a-z-i-d-e-m
xevlog	x-exe-v-l-o-g
nuzrobexzybu	n-unu-z-r-o-b-e-x-z-y-b-u
casbexmupnew	c-aca-s-b-e-x-m-u-p-n-e-w
qikisqu	q-iqi-k-i-s-q-u
gyqnackamity	g-ygy-q-n-a-c-k-a-m-i-t-y
jaxvyf	j-aja-x-v-y-f
tedovy	t-ete-d-o-v-y
vupuchaq	v-uvu-p-u-c-h-a-q
rox	r-oro-x
vez	v-eve-z
tidyh	t-iti-d-y-h
tutuxuk	t-utu-t-u-x-u-k
pihqaq	p-ipi-h-q-a-q
riquvwotehge	r-iri-q-u-v-w-o-t-e-h-g-e
cagfocyva	c-aca-g-f-o-c-y-v-a
bilhapdarog	b-ibi-l-h-a-p-d-a-r-o-g
butaq	b-ubu-t-a-q
wuril	w-uwu-r-i-l
qutij	q-uqu-t-i-j
quwahlanpov	q-uqu-w-a-h-l-a-n-p-o-v
gatzyfdegtypuq	g-aga-t-z-y-f-d-e-g-t-y-p-u-q
palhut	p-apa-l-h-u-t
nuluwfezmyfzu	n-unu-l-u-w-f-e-z-m-y-f-z-u
xadpovporompoq	x-axa-d-p-o-v-p-o-r-o-m-p-o-q
suvno	s-usu-v-n-o
zivnejef	z-izi-v-n-e-j-e-f
hezceb	h-ehe-z-c-e-b
japat	j-aja-p-a-t
xihzud	x-ixi-h-z-u-d
dyfxot	d-ydy-f-x-o-t
qyvul	q-yqy-v-u-l
gewuvje	g-ege-w-u-v-j-e
baqal	b-aba-q-a-l
refvy	r-ere-f-v-y
symadu	s-ysy-m-a-d-u
du	d-udu
kofehpehe	k-oko-f-e-h-p-e-h-e
temygfiqes	t-ete-m-y-g-f-i-q-e-s
vax	v-ava-x
muztydilcig	m-umu-z-t-y-d-i-l-c-i-g
jusiboqtiwa	j-uju-s-i-b-o-q-t-i-w-a
godbyqlamrexeh	g-ogo-d-b-y-q-l-a-m-r-e-x-e-h
tazgi	t-ata-z-g-i
mosihnuclemlan	m-omo-s-i-h-n-u-c-l-e-m-l-a-n
wustov	w-uwu-s-t-o-v
zebitih	z-eze-b-i-t-i-h
fexa	f-efe-x-a
sujuqahzubyc	s-usu-j-u-q-a-h-z-u-b-y-c
pofuq	p-opo-f-u-q
wiqlacpo	w-iwi-q-l-a-c-p-o
jolbypyc	j-ojo-l-b-y-p-y-c
fehehdyxu	f-efe-h-e-h-d-y-x-u
gudsehexykdap	g-ugu-d-s-e-h-e-x-y-k-d-a-p
dedoxebofxex	d-ede-d-o-x-e-b-o-f-x-e-x
jubi	j-uju-b-i
cowvuqaf	c-oco-w-v-u-q-a-f
cesyk	c-ece-s-y-k
zeb	z-eze-b
qaget	q-aqa-g-e-t
ruhu	r-uru-h-u
cecimexi	c-ece-c-i-m-e-x-i
poxfytqiga	p-opo-x-f-y-t-q-i-g-a
delyw	d-ede-l-y-w
futcobyxy	f-ufu-t-c-o-b-y-x-y
sakyg	s-asa-k-y-g
razojguz	r-ara-z-o-j-g-u-z
hugxodwaf	h-uhu-g-x-o-d-w-a-f
qirtyg	q-iqi-r-t-y-g
nixnew	n-ini-x-n-e-w
qedzadedqy	q-eqe-d-z-a-d-e-d-q-y
kocifyloz	k-oko-c-i-f-y-l-o-z
zywzor	z-yzy-w-z-o-r
campux	c-aca-m-p-u-x
sevbu	s-ese-v-b-u
xubkem	x-uxu-b-k-e-m
xuf	x-uxu-f
bewcivzo	b-ebe-w-c-i-v-z-o
lojidvudyrfa	l-olo-j-i-d-v-u-d-y-r-f-a
qucugho	q-uqu-c-u-g-h-o
wylsix	w-ywy-l-s-i-x
wycqazattet	w-ywy-c-q-a-z-a-t-t-e-t
tyxxu	t-yty-x-x-u
rujruxa	r-uru-j-r-u-x-a
qepka	q-eqe-p-k-a
fuzu	f-ufu-z-u
gezkyrgim	g-ege-z-k-y-r-g-i-m
sopdo	s-oso-p-d-o
tykadbybypwid	t-yty-k-a-d-b-y-b-y-p-w-i-d
zypdu	z-yzy-p-d-u
xudibatdub	x-uxu-d-i-b-a-t-d-u-b
jat	j-aja-t
xesuv	x-exe-s-u-v
rirxi	r-iri-r-x-i
negohsonsypzi	n-ene-g-o-h-s-o-n-s-y-p-z-i
xurzanyrcup	x-uxu-r-z-a-n-y-r-c-u-p
hovunby	h-oho-v-u-n-b-y
laragru	l-ala-r-a-g-r-u
mebygo	m-eme-b-y-g-o
qan	q-aqa-n
kaszud	k-aka-s-z-u-d
wyqusbaj	w-ywy-q-u-s-b-a-j
satpudo	s-asa-t-p-u-d-o
pej	p-epe-j
gyhy	g-ygy-h-y
roqlajemja	r-oro-q-l-a-j-e-m-j-a
kobyxefezwev	k-oko-b-y-x-e-f-e-z-w-e-v
vet	v-eve-t
zizycoqkit	z-izi-z-y-c-o-q-k-i-t
ximajwiza	x-ixi-m-a-j-w-i-z-a
lujbevpywlo	l-ulu-j-b-e-v-p-y-w-l-o
pibze	p-ipi-b-z-e
vircos	v-ivi-r-c-o-s
gavik	g-aga-v-i-k
vytef	v-yvy-t-e-f
zidnoqroglun	z-izi-d-n-o-q-r-o-g-l-u-n
dasnazpet	d-ada-s-n-a-z-p-e-t
hegumdegic	h-ehe-g-u-m-d-e-g-i-c
gy	g-ygy
lexcod	l-ele-x-c-o-d
qucux	q-uqu-c-u-x
lycdybciv	l-yly-c-d-y-b-c-i-v
qify	q-iqi-f-y
gozivqij	g-ogo-z-i-v-q-i-j
hudapzozwo	h-uhu-d-a-p-z-o-z-w-o
xowar	x-oxo-w-a-r
lepe	l-ele-p-e
zazef	z-aza-z-e-f
dulzuritrog	d-udu-l-z-u-r-i-t-r-o-g
rehodo	r-ere-h-o-d-o
damqiz	d-ada-m-q-i-z
losrugtu	l-olo-s-r-u-g-t-u
huszetqigyh	h-uhu-s-z-e-t-q-i-g-y-h
ruxka	r-uru-x-k-a
zynheqvuky	z-yzy-n-h-e-q-v-u-k-y
pojqek	p-opo-j-q-e-k
dotzup	d-odo-t-z-u-p
wogcu	w-owo-g-c-u
fycomlobmyrpyq	f-yfy-c-o-m-l-o-b-m-y-r-p-y-q
nuvugy	n-unu-v-u-g-y
lazhof	l-ala-z-h-o-f
banro	b-aba-n-r-o
rez	r-ere-z
nilmic	n-ini-l-m-i-c
nefbel	n-ene-f-b-e-l
ximtin	x-ixi-m-t-i-n
hezpy	h-ehe-z-p-y
hykna	h-yhy-k-n-a
vilhufgej	v-ivi-l-h-u-f-g-e-j
lornag	l-olo-r-n-a-g
lucgiqwy	l-ulu-c-g-i-q-w-y
garekfycuk	g-aga-r-e-k-f-y-c-u-k
xize	x-ixi-z-e
xoxy	x-oxo-x-y
zo	z-ozo
gekawmyr	g-ege-k-a-w-m-y-r
rifik	r-iri-f-i-k
noherzo	n-ono-h-e-r-z-o
vajdezpecvapha	v-ava-j-d-e-z-p-e-c-v-a-p-h-a
rawukobutu	r-ara-w-u-k-o-b-u-t-u
fic	f-ifi-c
rofa	r-oro-f-a
bajymcidugib	b-aba-j-y-m-c-i-d-u-g-i-b
sejfudit	s-ese-j-f-u-d-i-t
lona	l-olo-n-a
zismaxopjapod	z-izi-s-m-a-x-o-p-j-a-p-o-d
habximmiv	h-aha-b-x-i-m-m-i-v
xumyt	x-uxu-m-y-t
nivqip	n-ini-v-q-i-p
tor	t-oto-r
gop	g-ogo-p
ziznydjoh	z-izi-z-n-y-d-j-o-h
jikumvexxahaj	j-iji-k-u-m-v-e-x-x-a-h-a-j
gasleq	g-aga-s-l-e-q
qile	q-iqi-l-e
vozlevyfnyv	v-ovo-z-l-e-v-y-f-n-y-v
pikxenyhta	p-ipi-k-x-e-n-y-h-t-a
fuhu	f-ufu-h-u
lyv	l-yly-v
luwza	l-ulu-w-z-a
wyq	w-ywy-q
xykdu	x-yxy-k-d-u
havog	h-aha-v-o-g
bytoxxy	b-yby-t-o-x-x-y
tuce	t-utu-c-e
ryqwefqyzu	r-yry-q-w-e-f-q-y-z-u
jigopudry	j-iji-g-o-p-u-d-r-y
tuzmokgo	t-utu-z-m-o-k-g-o
lojep	l-olo-j-e-p
hu	h-uhu
rabylyk	r-ara-b-y-l-y-k
qyxvuc	q-yqy-x-v-u-c
zuhdojtepsofi	z-uzu-h-d-o-j-t-e-p-s-o-f-i
fyw	f-yfy-w
dyxeb	d-ydy-x-e-b
duzmezxorgiq	d-udu-z-m-e-z-x-o-r-g-i-q
taqvoh	t-ata-q-v-o-h
binpi	b-ibi-n-p-i
cajla	c-aca-j-l-a
madopomyt	m-ama-d-o-p-o-m-y-t
kegjabhajwik	k-eke-g-j-a-b-h-a-j-w-i-k
nowsol	n-ono-w-s-o-l
narjiba	n-ana-r-j-i-b-a
nyzyjuqa	n-yny-z-y-j-u-q-a
dinkoken	d-idi-n-k-o-k-e-n
tur	t-utu-r
pin	p-ipi-n
xiw	x-ixi-w
dyzpode	d-ydy-z-p-o-d-e
wilox	w-iwi-l-o-x
fugbechelav	f-ufu-g-b-e-c-h-e-l-a-v
xotyk	x-oxo-t-y-k
nydfozepax	n-yny-d-f-o-z-e-p-a-x
xypybe	x-yxy-p-y-b-e
gipguv	g-igi-p-g-u-v
wejsize	w-ewe-j-s-i-z-e
syva	s-ysy-v-a
xemmo	x-exe-m-m-o
nago	n-ana-g-o
vuloxejylfaj	v-uvu-l-o-x-e-j-y-l-f-a-j
nywwon	n-yny-w-w-o-n
jagof	j-aja-g-o-f
mate	m-ama-t-e
zazi	z-aza-z-i
kacfify	k-aka-c-f-i-f-y
vamo	v-ava-m-o
juzwizvyji	j-uju-z-w-i-z-v-y-j-i
nupy	n-unu-p-y
petur	p-epe-t-u-r
byny	b-yby-n-y
buqjex	b-ubu-q-j-e-x
zyjujzy	z-yzy-j-u-j-z-y
sovudyfbynos	s-oso-v-u-d-y-f-b-y-n-o-s
nuppu	n-unu-p-p-u
qyfganeltys	q-yqy-f-g-a-n-e-l-t-y-s
hew	h-ehe-w
guq	g-ugu-q
cozrydver	c-oco-z-r-y-d-v-e-r
qoqanu	q-oqo-q-a-n-u
mihocy	m-imi-h-o-c-y
ruwvobyqvapum	r-uru-w-v-o-b-y-q-v-a-p-u-m
xujupeb	x-uxu-j-u-p-e-b
zojecuj	z-ozo-j-e-c-u-j
fihwa	f-ifi-h-w-a
hani	h-aha-n-i
xicwekapycep	x-ixi-c-w-e-k-a-p-y-c-e-p
puhu	p-upu-h-u
wer	w-ewe-r
cimpuv	c-ici-m-p-u-v
kulyl	k-uku-l-y-l
tahbajnajra	t-ata-h-b-a-j-n-a-j-r-a
parizdave	p-apa-r-i-z-d-a-v-e
wijlywanlytaz	w-iwi-j-l-y-w-a-n-l-y-t-a-z
qepuxdu	q-eqe-p-u-x-d-u
bazwa	b-aba-z-w-a
jydipgadymcy	j-yjy-d-i-p-g-a-d-y-m-c-y
tezixavbibre	t-ete-z-i-x-a-v-b-i-b-r-e
gihdybzoxad	g-igi-h-d-y-b-z-o-x-a-d
xemfolza	x-exe-m-f-o-l-z-a
qasvyn	q-aqa-s-v-y-n
roviq	r-oro-v-i-q
pub	p-upu-b
vuxabyhsuxyw	v-uvu-x-a-b-y-h-s-u-x-y-w
sobyg	s-oso-b-y-g
xufek	x-uxu-f-e-k
negqylos	n-ene-g-q-y-l-o-s
hyl	h-yhy-l
had	h-aha-d
zavsyxer	z-aza-v-s-y-x-e-r
xabvil	x-axa-b-v-i-l
dijqi	d-idi-j-q-i
jokalvir	j-ojo-k-a-l-v-i-r
tekqysnufud	t-ete-k-q-y-s-n-u-f-u-d
vuxy	v-uvu-x-y
fuksaveh	f-ufu-k-s-a-v-e-h
davi	d-ada-v-i
hejcoscukxa	h-ehe-j-c-o-s-c-u-k-x-a
famewfe	f-afa-m-e-w-f-e
ducemra	d-udu-c-e-m-r-a
wefsixho	w-ewe-f-s-i-x-h-o
qypub	q-yqy-p-u-b
nixhemu	n-ini-x-h-e-m-u
raqevnyjbify	r-ara-q-e-v-n-y-j-b-i-f-y
nirfamcyxtopda	n-ini-r-f-a-m-c-y-x-t-o-p-d-a
zyntoxo	z-yzy-n-t-o-x-o
leki	l-ele-k-i
zybesix	z-yzy-b-e-s-i-x
duqo	d-udu-q-o
weqonqiffoliv	w-ewe-q-o-n-q-i-f-f-o-l-i-v
bawny	b-aba-w-n-y
qiw	q-iqi-w
hav	h-aha-v
wob	w-owo-b
dajbo	d-ada-j-b-o
donkyq	d-odo-n-k-y-q
fogbopyg	f-ofo-g-b-o-p-y-g
jopxelofweq	j-ojo-p-x-e-l-o-f-w-e-q
woxyshyhux	w-owo-x-y-s-h-y-h-u-x
zycpiqe	z-yzy-c-p-i-q-e
daky	d-ada-k-y
tuqexfowoz	t-utu-q-e-x-f-o-w-o-z
pahet	p-apa-h-e-t
fez	f-efe-z
lynwosejga	l-yly-n-w-o-s-e-j-g-a
viqo	v-ivi-q-o
wicsoknojjiwkus	w-iwi-c-s-o-k-n-o-j-j-i-w-k-u-s
loqfo	l-olo-q-f-o
bawyse	b-aba-w-y-s-e
xycup	x-yxy-c-u-p
cuca	c-ucu-c-a
gerkeq	g-ege-r-k-e-q
xoquz	x-oxo-q-u-z
nifceky	n-ini-f-c-e-k-y
gatywiri	g-aga-t-y-w-i-r-i
tibonhavrazyx	t-iti-b-o-n-h-a-v-r-a-z-y-x
wockoldy	w-owo-c-k-o-l-d-y
sowqik	s-oso-w-q-i-k
kitcow	k-iki-t-c-o-w
cubfalvytuc	c-ucu-b-f-a-l-v-y-t-u-c
bogycuj	b-obo-g-y-c-u-j
xaf	x-axa-f
maloxfigogu	m-ama-l-o-x-f-i-g-o-g-u
cuhsyhjy	c-ucu-h-s-y-h-j-y
bymni	b-yby-m-n-i
ryzpyxmicry	r-yry-z-p-y-x-m-i-c-r-y
bapzotxuk	b-aba-p-z-o-t-x-u-k
tyrhohatsyxe	t-yty-r-h-o-h-a-t-s-y-x-e
cytocycli	c-ycy-t-o-c-y-c-l-i
dic	d-idi-c
qibcotzy	q-iqi-b-c-o-t-z-y
wifkukitqom	w-iwi-f-k-u-k-i-t-q-o-m
nevgyj	n-ene-v-g-y-j
wivirycakqe	w-iwi-v-i-r-y-c-a-k-q-e
zysxus	z-yzy-s-x-u-s
dawajeni	d-ada-w-a-j-e-n-i
qimzojidy	q-iqi-m-z-o-j-i-d-y
fyfutmij	f-yfy-f-u-t-m-i-j
xybtu	x-yxy-b-t-u
tisfoliwsuw	t-iti-s-f-o-l-i-w-s-u-w
jyqa	j-yjy-q-a
gymmazer	g-ygy-m-m-a-z-e-r
mogu	m-omo-g-u
mecoq	m-eme-c-o-q
xexa	x-exe-x-a
towdi	t-oto-w-d-i
bodgeco	b-obo-d-g-e-c-o
pipyx	p-ipi-p-y-x
dehuqesoddow	d-ede-h-u-q-e-s-o-d-d-o-w
wap	w-awa-p
jygu	j-yjy-g-u
kiwab	k-iki-w-a-b
vafuternuxtu	v-ava-f-u-t-e-r-n-u-x-t-u
coqxup	c-oco-q-x-u-p
hydav	h-yhy-d-a-v
vodka	v-ovo-d-k-a
zohso	z-ozo-h-s-o
pepdyb	p-epe-p-d-y-b
bufcilmugbu	b-ubu-f-c-i-l-m-u-g-b-u
madxanwev	m-ama-d-x-a-n-w-e-v
tipqube	t-iti-p-q-u-b-e
tunkojkannettaw	t-utu-n-k-o-j-k-a-n-n-e-t-t-a-w
cyztaggah	c-ycy-z-t-a-g-g-a-h
zarethykymy	z-aza-r-e-t-h-y-k-y-m-y
sokot	s-oso-k-o-t
luxowbu	l-ulu-x-o-w-b-u
waxluq	w-awa-x-l-u-q
kati	k-aka-t-i
vyxicy	v-yvy-x-i-c-y
fazcuta	f-afa-z-c-u-t-a
kywud	k-yky-w-u-d
himgu	h-ihi-m-g-u
fitsix	f-ifi-t-s-i-x
fyculcel	f-yfy-c-u-l-c-e-l
fawnon	f-afa-w-n-o-n
gub	g-ugu-b
pohy	p-opo-h-y
mopxequ	m-omo-p-x-e-q-u
sentikxy	s-ese-n-t-i-k-x-y
xymesnepadvyr	x-yxy-m-e-s-n-e-p-a-d-v-y-r
gemer	g-ege-m-e-r
pusoto	p-upu-s-o-t-o
kus	k-uku-s
fili	f-ifi-l-i
rilqowalkali	r-iri-l-q-o-w-a-l-k-a-l-i
katowqawovlyx	k-aka-t-o-w-q-a-w-o-v-l-y-x
deli	d-ede-l-i
cu	c-ucu
xigol	x-ixi-g-o-l
cedy	c-ece-d-y
baje	b-aba-j-e
lybceb	l-yly-b-c-e-b
xani	x-axa-n-i
wij	w-iwi-j
keteq	k-eke-t-e-q
qabik	q-aqa-b-i-k
gufhy	g-ugu-f-h-y
mipafbugo	m-imi-p-a-f-b-u-g-o
midy	m-imi-d-y
lycnobve	l-yly-c-n-o-b-v-e
xaxotu	x-axa-x-o-t-u
zawuzah	z-aza-w-u-z-a-h
siczas	s-isi-c-z-a-s
rujazew	r-uru-j-a-z-e-w
rumuk	r-uru-m-u-k
jamaq	j-aja-m-a-q
legmumfywaqne	l-ele-g-m-u-m-f-y-w-a-q-n-e
wez	w-ewe-z
xunvimfusrefto	x-uxu-n-v-i-m-f-u-s-r-e-f-t-o
quvjez	q-uqu-v-j-e-z
fixi	f-ifi-x-i
monfugbany	m-omo-n-f-u-g-b-a-n-y
jahsu	j-aja-h-s-u
gawqi	g-aga-w-q-i
mybho	m-ymy-b-h-o
dyp	d-ydy-p
vuzowyvlu	v-uvu-z-o-w-y-v-l-u
fubho	f-ufu-b-h-o
kygmytiqukfy	k-yky-g-m-y-t-i-q-u-k-f-y
mabdocedvu	m-ama-b-d-o-c-e-d-v-u
nymati	n-yny-m-a-t-i
lifi	l-ili-f-i
qyhcosjewocma	q-yqy-h-c-o-s-j-e-w-o-c-m-a
dem	d-ede-m
rij	r-iri-j
zurxonyk	z-uzu-r-x-o-n-y-k
cotkir	c-oco-t-k-i-r
gava	g-aga-v-a
cajurtasocux	c-aca-j-u-r-t-a-s-o-c-u-x
kapasy	k-aka-p-a-s-y
nosmecdenfew	n-ono-s-m-e-c-d-e-n-f-e-w
vojam	v-ovo-j-a-m
nytic	n-yny-t-i-c
dipkev	d-idi-p-k-e-v
koqgaz	k-oko-q-g-a-z
wyqut	w-ywy-q-u-t
cykrat	c-ycy-k-r-a-t
nopwesobmy	n-ono-p-w-e-s-o-b-m-y
qahrax	q-aqa-h-r-a-x
bodzehekne	b-obo-d-z-e-h-e-k-n-e
heblu	h-ehe-b-l-u
fekybgatatux	f-efe-k-y-b-g-a-t-a-t-u-x
misobba	m-imi-s-o-b-b-a
wyt	w-ywy-t
mujilavlu	m-umu-j-i-l-a-v-l-u
qomu	q-oqo-m-u
qobihri	q-oqo-b-i-h-r-i
qyvum	q-yqy-v-u-m
mob	m-omo-b
ridux	r-iri-d-u-x
wuhvasizpi	w-uwu-h-v-a-s-i-z-p-i
qyvzag	q-yqy-v-z-a-g
lyrzepoj	l-yly-r-z-e-p-o-j
migozixmyphe	m-imi-g-o-z-i-x-m-y-p-h-e
hulgy	h-uhu-l-g-y
ruzizisbo	r-uru-z-i-z-i-s-b-o
xypcujikbog	x-yxy-p-c-u-j-i-k-b-o-g
xudsykhikih	x-uxu-d-s-y-k-h-i-k-i-h
sylxat	s-ysy-l-x-a-t
honytuqipi	h-oho-n-y-t-u-q-i-p-i
zure	z-uzu-r-e
sicet	s-isi-c-e-t
kelit	k-eke-l-i-t
motjup	m-omo-t-j-u-p
hofzojlahci	h-oho-f-z-o-j-l-a-h-c-i
cywy	c-ycy-w-y
wemir	w-ewe-m-i-r
jowan	j-ojo-w-a-n
mosfok	m-omo-s-f-o-k
hytry	h-yhy-t-r-y
pogune	p-opo-g-u-n-e
daxohkylec	d-ada-x-o-h-k-y-l-e-c
punpam	p-upu-n-p-a-m
kofub	k-oko-f-u-b
net	n-ene-t
wycpep	w-ywy-c-p-e-p
val	v-ava-l
nitymzufpilzyz	n-ini-t-y-m-z-u-f-p-i-l-z-y-z
rapib	r-ara-p-i-b
xuhqe	x-uxu-h-q-e
kigyjliklu	k-iki-g-y-j-l-i-k-l-u
fyvre	f-yfy-v-r-e
petivykbohe	p-epe-t-i-v-y-k-b-o-h-e
fegronmijef	f-efe-g-r-o-n-m-i-j-e-f
wujiskadbirzu	w-uwu-j-i-s-k-a-d-b-i-r-z-u
cusazvy	c-ucu-s-a-z-v-y
mimuscaw	m-imi-m-u-s-c-a-w
mukruwked	m-umu-k-r-u-w-k-e-d
qogsic	q-oqo-g-s-i-c
zuvku	z-uzu-v-k-u
diqyvqekovgy	d-idi-q-y-v-q-e-k-o-v-g-y
zypsop	z-yzy-p-s-o-p
suhuk	s-usu-h-u-k
jymaxek	j-yjy-m-a-x-e-k
dakefux	d-ada-k-e-f-u-x
wifrisce	w-iwi-f-r-i-s-c-e
mipuqfuxvymvyg	m-imi-p-u-q-f-u-x-v-y-m-v-y-g
hesefitvyle	h-ehe-s-e-f-i-t-v-y-l-e
qubyx	q-uqu-b-y-x
huqlacgi	h-uhu-q-l-a-c-g-i
rewxeb	r-ere-w-x-e-b
lumo	l-ulu-m-o
nav	n-ana-v
zuba	z-uzu-b-a
zaz	z-aza-z
huzroggy	h-uhu-z-r-o-g-g-y
qozol	q-oqo-z-o-l
fidesmexed	f-ifi-d-e-s-m-e-x-e-d
veg	v-eve-g
vypsomwazrupu	v-yvy-p-s-o-m-w-a-z-r-u-p-u
kivomsemputruw	k-iki-v-o-m-s-e-m-p-u-t-r-u-w
jeb	j-eje-b
xyle	x-yxy-l-e
tinjixqydbykyg	t-iti-n-j-i-x-q-y-d-b-y-k-y-g
hafiv	h-aha-f-i-v
fexe	f-efe-x-e
vismoh	v-ivi-s-m-o-h
jis	j-iji-s
gawno	g-aga-w-n-o
foxxudjom	f-ofo-x-x-u-d-j-o-m
jekar	j-eje-k-a-r
lepa	l-ele-p-a
capnesylvuf	c-aca-p-n-e-s-y-l-v-u-f
tejuhuk	t-ete-j-u-h-u-k
wilqomtuj	w-iwi-l-q-o-m-t-u-j
camvov	c-aca-m-v-o-v
mixinge	m-imi-x-i-n-g-e
vonpikrusu	v-ovo-n-p-i-k-r-u-s-u
kybusywpa	k-yky-b-u-s-y-w-p-a
beljo	b-ebe-l-j-o
kufsihconyza	k-uku-f-s-i-h-c-o-n-y-z-a
gomdeqyqyseb	g-ogo-m-d-e-q-y-q-y-s-e-b
dire	d-idi-r-e
vonwah	v-ovo-n-w-a-h
jep	j-eje-p
lyrgyjje	l-yly-r-g-y-j-j-e
hewsipnyka	h-ehe-w-s-i-p-n-y-k-a
jywag	j-yjy-w-a-g
xehruge	x-exe-h-r-u-g-e
cifozge	c-ici-f-o-z-g-e
bajono	b-aba-j-o-n-o
nyty	n-yny-t-y
sawco	s-asa-w-c-o
wenuc	w-ewe-n-u-c
wyfcas	w-ywy-f-c-a-s
pybig	p-ypy-b-i-g
cexjepdynywto	c-ece-x-j-e-p-d-y-n-y-w-t-o
nixhelogmy	n-ini-x-h-e-l-o-g-m-y
zaknogqojufyn	z-aza-k-n-o-g-q-o-j-u-f-y-n
fyzuz	f-yfy-z-u-z
xenrudoz	x-exe-n-r-u-d-o-z
remuky	r-ere-m-u-k-y
xebuxis	x-exe-b-u-x-i-s
xonny	x-oxo-n-n-y
hak	h-aha-k
dali	d-ada-l-i
mabud	m-ama-b-u-d
wyvatorem	w-ywy-v-a-t-o-r-e-m
qofo	q-oqo-f-o
darlu	d-ada-r-l-u
doliseztowy	d-odo-l-i-s-e-z-t-o-w-y
dusahdi	d-udu-s-a-h-d-i
bovsiz	b-obo-v-s-i-z
bowsus	b-obo-w-s-u-s
notuxu	n-ono-t-u-x-u
nurid	n-unu-r-i-d
lyny	l-yly-n-y
jojyrwiq	j-ojo-j-y-r-w-i-q
pupex	p-upu-p-e-x
zovu	z-ozo-v-u
dedgogtu	d-ede-d-g-o-g-t-u
sif	s-isi-f
ceccemyq	c-ece-c-c-e-m-y-q
veznum	v-eve-z-n-u-m
zysul	z-yzy-s-u-l
sobmecfefveky	s-oso-b-m-e-c-f-e-f-v-e-k-y
keba	k-eke-b-a
pir	p-ipi-r
cantugcejobho	c-aca-n-t-u-g-c-e-j-o-b-h-o
dufikqibdoj	d-udu-f-i-k-q-i-b-d-o-j
tavomsymjipul	t-ata-v-o-m-s-y-m-j-i-p-u-l
cojgus	c-oco-j-g-u-s
mibad	m-imi-b-a-d
lobqe	l-olo-b-q-e
kyxi	k-yky-x-i
bymqypnyspyfjez	b-yby-m-q-y-p-n-y-s-p-y-f-j-e-z
lidkeqdixi	l-ili-d-k-e-q-d-i-x-i
qonduxuhnisih	q-oqo-n-d-u-x-u-h-n-i-s-i-h
funsodpudokvy	f-ufu-n-s-o-d-p-u-d-o-k-v-y
tiwkih	t-iti-w-k-i-h
cagyc	c-aca-g-y-c
zylwavmilxilyv	z-yzy-l-w-a-v-m-i-l-x-i-l-y-v
xyvheda	x-yxy-v-h-e-d-a
pozdum	p-opo-z-d-u-m
putiblib	p-upu-t-i-b-l-i-b
neviqe	n-ene-v-i-q-e
makoqdiltu	m-ama-k-o-q-d-i-l-t-u
qygzumu	q-yqy-g-z-u-m-u
kofukyhoxu	k-oko-f-u-k-y-h-o-x-u
nopvuxso	n-ono-p-v-u-x-s-o
lumtazralade	l-ulu-m-t-a-z-r-a-l-a-d-e
gecjeno	g-ege-c-j-e-n-o
dudi	d-udu-d-i
vilikly	v-ivi-l-i-k-l-y
lypno	l-yly-p-n-o
gixqoldaxja	g-igi-x-q-o-l-d-a-x-j-a
kawfyha	k-aka-w-f-y-h-a
hadizzemby	h-aha-d-i-z-z-e-m-b-y
zysafu	z-yzy-s-a-f-u
vajzevma	v-ava-j-z-e-v-m-a
hoqfyw	h-oho-q-f-y-w
mujjuzjabo	m-umu-j-j-u-z-j-a-b-o
kacoqujwucjo	k-aka-c-o-q-u-j-w-u-c-j-o
rukmil	r-uru-k-m-i-l
nynybcur	n-yny-n-y-b-c-u-r
byljat	b-yby-l-j-a-t
hyjmoj	h-yhy-j-m-o-j
lobpocev	l-olo-b-p-o-c-e-v
goqyhjunisguq	g-ogo-q-y-h-j-u-n-i-s-g-u-q
gaso	g-aga-s-o
xicle	x-ixi-c-l-e
divim	d-idi-v-i-m
dyjoq	d-ydy-j-o-q
welkulce	w-ewe-l-k-u-l-c-e
raty	r-ara-t-y
vutul	v-uvu-t-u-l
xugdugune	x-uxu-g-d-u-g-u-n-e
jaxpy	j-aja-x-p-y
lecfic	l-ele-c-f-i-c
koci	k-oko-c-i
gytyxub	g-ygy-t-y-x-u-b
wykes	w-ywy-k-e-s
juqu	j-uju-q-u
jajiqfyt	j-aja-j-i-q-f-y-t
fepnuwbur	f-efe-p-n-u-w-b-u-r
dybzepdiz	d-ydy-b-z-e-p-d-i-z
zalwy	z-aza-l-w-y
pohkedguv	p-opo-h-k-e-d-g-u-v
kynejol	k-yky-n-e-j-o-l
qig	q-iqi-g
banwagdy	b-aba-n-w-a-g-d-y
saldy	s-asa-l-d-y
vahjy	v-ava-h-j-y
kikit	k-iki-k-i-t
zegjusor	z-eze-g-j-u-s-o-r
lendyvxenvumo	l-ele-n-d-y-v-x-e-n-v-u-m-o
baso	b-aba-s-o
feqajve	f-efe-q-a-j-v-e
qyz	q-yqy-z
nevsyza	n-ene-v-s-y-z-a
kun	k-uku-n
mynowpe	m-ymy-n-o-w-p-e
cexoly	c-ece-x-o-l-y
lidorxucbat	l-ili-d-o-r-x-u-c-b-a-t
duhhym	d-udu-h-h-y-m
kyvycyhyr	k-yky-v-y-c-y-h-y-r
wuhmalekhaq	w-uwu-h-m-a-l-e-k-h-a-q
qolo	q-oqo-l-o
numwa	n-unu-m-w-a
zogipyw	z-ozo-g-i-p-y-w
ryt	r-yry-t
zusygytfumoc	z-uzu-s-y-g-y-t-f-u-m-o-c
fuqetah	f-ufu-q-e-t-a-h
jajetaq	j-aja-j-e-t-a-q
bigofiz	b-ibi-g-o-f-i-z
xywissiz	x-yxy-w-i-s-s-i-z
dorzar	d-odo-r-z-a-r
pysocqac	p-ypy-s-o-c-q-a-c
kexfa	k-eke-x-f-a
tokovuj	t-oto-k-o-v-u-j
vyqy	v-yvy-q-y
betvyncukegap	b-ebe-t-v-y-n-c-u-k-e-g-a-p
mizmale	m-imi-z-m-a-l-e
cexpu	c-ece-x-p-u
guba	g-ugu-b-a
ne	n-ene
micjo	m-imi-c-j-o
qobi	q-oqo-b-i
bigyle	b-ibi-g-y-l-e
pulaf	p-upu-l-a-f
nufgec	n-unu-f-g-e-c
donzihelwe	d-odo-n-z-i-h-e-l-w-e
nijnix	n-ini-j-n-i-x
cyjzuk	c-ycy-j-z-u-k
sekcup	s-ese-k-c-u-p
zifqyr	z-izi-f-q-y-r
tatnumdoc	t-ata-t-n-u-m-d-o-c
niqefpeskudy	n-ini-q-e-f-p-e-s-k-u-d-y
xux	x-uxu-x
zuciv	z-uzu-c-i-v
pys	p-ypy-s
nubex	n-unu-b-e-x
jizgojyxezju	j-iji-z-g-o-j-y-x-e-z-j-u
vemar	v-eve-m-a-r
didvuvotimyz	d-idi-d-v-u-v-o-t-i-m-y-z
rynar	r-yry-n-a-r
webysi	w-ewe-b-y-s-i
gomy	g-ogo-m-y
vasu	v-ava-s-u
luskybmif	l-ulu-s-k-y-b-m-i-f
pehugyc	p-epe-h-u-g-y-c
xuka	x-uxu-k-a
xyf	x-yxy-f
muzvizoteto	m-umu-z-v-i-z-o-t-e-t-o
xowek	x-oxo-w-e-k
zididitoxkuw	z-izi-d-i-d-i-t-o-x-k-u-w
vitefyzwa	v-ivi-t-e-f-y-z-w-a
pyvkyvdaluto	p-ypy-v-k-y-v-d-a-l-u-t-o
cyvcudeq	c-ycy-v-c-u-d-e-q
tyh	t-yty-h
godjokyl	g-ogo-d-j-o-k-y-l
bucgyrsebovuc	b-ubu-c-g-y-r-s-e-b-o-v-u-c
rajulon	r-ara-j-u-l-o-n
pochi	p-opo-c-h-i
vywijwur	v-yvy-w-i-j-w-u-r
zyp	z-yzy-p
vuqyxivfu	v-uvu-q-y-x-i-v-f-u
vykesanve	v-yvy-k-e-s-a-n-v-e
dijva	d-idi-j-v-a
cuslefytuc	c-ucu-s-l-e-f-y-t-u-c
giwvep	g-igi-w-v-e-p
wilqyv	w-iwi-l-q-y-v
jurlibci	j-uju-r-l-i-b-c-i
puqmokec	p-upu-q-m-o-k-e-c
qisin	q-iqi-s-i-n
gom	g-ogo-m
givif	g-igi-v-i-f
didyl	d-idi-d-y-l
cewjyk	c-ece-w-j-y-k
xijlus	x-ixi-j-l-u-s
tirpyntuqy	t-iti-r-p-y-n-t-u-q-y
sobowjoqwar	s-oso-b-o-w-j-o-q-w-a-r
loz	l-olo-z
bym	b-yby-m
cilysuwsysmy	c-ici-l-y-s-u-w-s-y-s-m-y
cajte	c-aca-j-t-e
samys	s-asa-m-y-s
hyvadkara	h-yhy-v-a-d-k-a-r-a
bekecgyg	b-ebe-k-e-c-g-y-g
luxax	l-ulu-x-a-x
sosoka	s-oso-s-o-k-a
zybgon	z-yzy-b-g-o-n
terib	t-ete-r-i-b
qoho	q-oqo-h-o
zymwuwzekxol	z-yzy-m-w-u-w-z-e-k-x-o-l
qis	q-iqi-s
tyse	t-yty-s-e
kaxxupy	k-aka-x-x-u-p-y
deplynjefux	d-ede-p-l-y-n-j-e-f-u-x
mahfu	m-ama-h-f-u
byke	b-yby-k-e
desamvawledeh	d-ede-s-a-m-v-a-w-l-e-d-e-h
zafcaby	z-aza-f-c-a-b-y
wafu	w-awa-f-u
ral	r-ara-l
demqyq	d-ede-m-q-y-q
kympyrucqysy	k-yky-m-p-y-r-u-c-q-y-s-y
zab	z-aza-b
rejuk	r-ere-j-u-k
vuhhyt	v-uvu-h-h-y-t
fetnynetfac	f-efe-t-n-y-n-e-t-f-a-c
kodu	k-oko-d-u
socmyg	s-oso-c-m-y-g
lefwiryxtobix	l-ele-f-w-i-r-y-x-t-o-b-i-x
lode	l-olo-d-e
tosurih	t-oto-s-u-r-i-h
jepim	j-eje-p-i-m
nasticersozyb	n-ana-s-t-i-c-e-r-s-o-z-y-b
mudwe	m-umu-d-w-e
kebtad	k-eke-b-t-a-d
xyfu	x-yxy-f-u
letuzacuz	l-ele-t-u-z-a-c-u-z
nuzuwsida	n-unu-z-u-w-s-i-d-a
zutu	z-uzu-t-u
humazu	h-uhu-m-a-z-u
cobak	c-oco-b-a-k
jekyvepydik	j-eje-k-y-v-e-p-y-d-i-k
lib	l-ili-b
gidijar	g-igi-d-i-j-a-r
hewepnimzij	h-ehe-w-e-p-n-i-m-z-i-j
zuxu	z-uzu-x-u
tirpiv	t-iti-r-p-i-v
loqeh	l-olo-q-e-h
sufpylipxyr	s-usu-f-p-y-l-i-p-x-y-r
dot	d-odo-t
cukdyh	c-ucu-k-d-y-h
rehawvakew	r-ere-h-a-w-v-a-k-e-w
wudqyh	w-uwu-d-q-y-h
fika	f-ifi-k-a
dovukkori	d-odo-v-u-k-k-o-r-i
nyzqetsohtubbih	n-yny-z-q-e-t-s-o-h-t-u-b-b-i-h
kethyx	k-eke-t-h-y-x
puwako	p-upu-w-a-k-o
finotuv	f-ifi-n-o-t-u-v
xekiriteb	x-exe-k-i-r-i-t-e-b
xaguh	x-axa-g-u-h
fixakura	f-ifi-x-a-k-u-r-a
xa	x-axa
qydfil	q-yqy-d-f-i-l
hujdyz	h-uhu-j-d-y-z
kocaxakryx	k-oko-c-a-x-a-k-r-y-x
pawqivled	p-apa-w-q-i-v-l-e-d
meqo	m-eme-q-o
pemsa	p-epe-m-s-a
linpafyw	l-ili-n-p-a-f-y-w
vohawgu	v-ovo-h-a-w-g-u
zobtezo	z-ozo-b-t-e-z-o
lobjar	l-olo-b-j-a-r
qovuhaz	q-oqo-v-u-h-a-z
cev	c-ece-v
myva	m-ymy-v-a
rajlozfafqinbal	r-ara-j-l-o-z-f-a-f-q-i-n-b-a-l
gyqfunher	g-ygy-q-f-u-n-h-e-r
jafduj	j-aja-f-d-u-j
muqede	m-umu-q-e-d-e
rapy	r-ara-p-y
wawculfymviqxyf	w-awa-w-c-u-l-f-y-m-v-i-q-x-y-f
ruha	r-uru-h-a
kaxultafuq	k-aka-x-u-l-t-a-f-u-q
xaswi	x-axa-s-w-i
foked	f-ofo-k-e-d
koxuh	k-oko-x-u-h
doba	d-odo-b-a
suqemizysnir	s-usu-q-e-m-i-z-y-s-n-i-r
rytak	r-yry-t-a-k
julwoqfi	j-uju-l-w-o-q-f-i
nodkyvax	n-ono-d-k-y-v-a-x
niweho	n-ini-w-e-h-o
fyxtuw	f-yfy-x-t-u-w
duk	d-udu-k
nipviguvovgy	n-ini-p-v-i-g-u-v-o-v-g-y
xiloggud	x-ixi-l-o-g-g-u-d
deqacwe	d-ede-q-a-c-w-e
cihnybiloz	c-ici-h-n-y-b-i-l-o-z
tuqrodapaf	t-utu-q-r-o-d-a-p-a-f
qerterqa	q-eqe-r-t-e-r-q-a
vylexudgomfu	v-yvy-l-e-x-u-d-g-o-m-f-u
vevsapylykpe	v-eve-v-s-a-p-y-l-y-k-p-e
qalutepafi	q-aqa-l-u-t-e-p-a-f-i
cili	c-ici-l-i
winnyb	w-iwi-n-n-y-b
qisbipogqazy	q-iqi-s-b-i-p-o-g-q-a-z-y
syqfyg	s-ysy-q-f-y-g
nyropodyveg	n-yny-r-o-p-o-d-y-v-e-g
tihaw	t-iti-h-a-w
sun	s-usu-n
lippe	l-ili-p-p-e
geqig	g-ege-q-i-g
noqudub	n-ono-q-u-d-u-b
cazifjiv	c-aca-z-i-f-j-i-v
qixxazta	q-iqi-x-x-a-z-t-a
lowy	l-olo-w-y
zyneteh	z-yzy-n-e-t-e-h
waglez	w-awa-g-l-e-z
zisjowoq	z-izi-s-j-o-w-o-q
bejkisu	b-ebe-j-k-i-s-u
qunoqyj	q-uqu-n-o-q-y-j
paju	p-apa-j-u
wilzeb	w-iwi-l-z-e-b
qiva	q-iqi-v-a
vuwfy	v-uvu-w-f-y
cefbum	c-ece-f-b-u-m
ruhir	r-uru-h-i-r
jevuwijuzge	j-eje-v-u-w-i-j-u-z-g-e
xoc	x-oxo-c
gimkyhycak	g-igi-m-k-y-h-y-c-a-k
wyle	w-ywy-l-e
bindi	b-ibi-n-d-i
pajoracim	p-apa-j-o-r-a-c-i-m
pulmys	p-upu-l-m-y-s
hejpawpiranced	h-ehe-j-p-a-w-p-i-r-a-n-c-e-d
hiwcek	h-ihi-w-c-e-k
texnyb	t-ete-x-n-y-b
qevagob	q-eqe-v-a-g-o-b
divyqaxes	d-idi-v-y-q-a-x-e-s
putco	p-upu-t-c-o
jygasik	j-yjy-g-a-s-i-k
luzij	l-ulu-z-i-j
vemac	v-eve-m-a-c
xerosbybder	x-exe-r-o-s-b-y-b-d-e-r
sofy	s-oso-f-y
rynqy	r-yry-n-q-y
deqehyd	d-ede-q-e-h-y-d
fiwdub	f-ifi-w-d-u-b
dan	d-ada-n
wa	w-awa
dydla	d-ydy-d-l-a
galaf	g-aga-l-a-f
gicy	g-igi-c-y
worqafkynibfyw	w-owo-r-q-a-f-k-y-n-i-b-f-y-w
zyvquqdej	z-yzy-v-q-u-q-d-e-j
hicikbi	h-ihi-c-i-k-b-i
lyjjafirkejdom	l-yly-j-j-a-f-i-r-k-e-j-d-o-m
kyfi	k-yky-f-i
zebtessodogew	z-eze-b-t-e-s-s-o-d-o-g-e-w
cyky	c-ycy-k-y
silpy	s-isi-l-p-y
vydoje	v-yvy-d-o-j-e
dewkamsa	d-ede-w-k-a-m-s-a
valjex	v-ava-l-j-e-x
vodcoxposwa	v-ovo-d-c-o-x-p-o-s-w-a
zyt	z-yzy-t
noggat	n-ono-g-g-a-t
dipqujtipaj	d-idi-p-q-u-j-t-i-p-a-j
cec	c-ece-c
qyrutfuzyv	q-yqy-r-u-t-f-u-z-y-v
kahgi	k-aka-h-g-i
pyw	p-ypy-w
jicitiswa	j-iji-c-i-t-i-s-w-a
tugsox	t-utu-g-s-o-x
riwtut	r-iri-w-t-u-t
sylowsavazel	s-ysy-l-o-w-s-a-v-a-z-e-l
nymjejyj	n-yny-m-j-e-j-y-j
qusgep	q-uqu-s-g-e-p
fivtexe	f-ifi-v-t-e-x-e
dugpalu	d-udu-g-p-a-l-u
vemdad	v-eve-m-d-a-d
zav	z-aza-v
heqlaku	h-ehe-q-l-a-k-u
zynilih	z-yzy-n-i-l-i-h
nytqehu	n-yny-t-q-e-h-u
mucu	m-umu-c-u
puhvytys	p-upu-h-v-y-t-y-s
jetqofymezoj	j-eje-t-q-o-f-y-m-e-z-o-j
nurcyh	n-unu-r-c-y-h
jogheqbevxuhyh	j-ojo-g-h-e-q-b-e-v-x-u-h-y-h
norfabxav	n-ono-r-f-a-b-x-a-v
sapqemeq	s-asa-p-q-e-m-e-q
junvazbac	j-uju-n-v-a-z-b-a-c
gygcy	g-ygy-g-c-y
zulbok	z-uzu-l-b-o-k
misetqetexbo	m-imi-s-e-t-q-e-t-e-x-b-o
xuzwe	x-uxu-z-w-e
cycy	c-ycy-c-y
byxa	b-yby-x-a
ruka	r-uru-k-a
lufex	l-ulu-f-e-x
waty	w-awa-t-y
gimubdec	g-igi-m-u-b-d-e-c
hutcyjjum	h-uhu-t-c-y-j-j-u-m
doxiw	d-odo-x-i-w
xyqe	x-yxy-q-e
botwix	b-obo-t-w-i-x
cydixaqucsu	c-ycy-d-i-x-a-q-u-c-s-u
bufelocij	b-ubu-f-e-l-o-c-i-j
nicocmappurxiv	n-ini-c-o-c-m-a-p-p-u-r-x-i-v
hulefqy	h-uhu-l-e-f-q-y
napkuq	n-ana-p-k-u-q
cyxy	c-ycy-x-y
lerlyb	l-ele-r-l-y-b
qesmibidejra	q-eqe-s-m-i-b-i-d-e-j-r-a
lebbyrbekoni	l-ele-b-b-y-r-b-e-k-o-n-i
bokuz	b-obo-k-u-z
jeksytemad	j-eje-k-s-y-t-e-m-a-d
sid	s-isi-d
kuh	k-uku-h
xetrotsu	x-exe-t-r-o-t-s-u
jejfuqdur	j-eje-j-f-u-q-d-u-r
daqqon	d-ada-q-q-o-n
lothynavko	l-olo-t-h-y-n-a-v-k-o
rihpun	r-iri-h-p-u-n
gudtitmihmo	g-ugu-d-t-i-t-m-i-h-m-o
wadgyzejusfol	w-awa-d-g-y-z-e-j-u-s-f-o-l
fuslavkogugub	f-ufu-s-l-a-v-k-o-g-u-g-u-b
gufoh	g-ugu-f-o-h
gu	g-ugu
lymta	l-yly-m-t-a
lybpod	l-yly-b-p-o-d
nidobdy	n-ini-d-o-b-d-y
feh	f-efe-h
dasheqqop	d-ada-s-h-e-q-q-o-p
fusgepy	f-ufu-s-g-e-p-y
sakvux	s-asa-k-v-u-x
peciczuv	p-epe-c-i-c-z-u-v
weqfuravefoz	w-ewe-q-f-u-r-a-v-e-f-o-z
lef	l-ele-f
nuji	n-unu-j-i
wewydfes	w-ewe-w-y-d-f-e-s
wupexy	w-uwu-p-e-x-y
vofvakterizan	v-ovo-f-v-a-k-t-e-r-i-z-a-n
nog	n-ono-g
dijtoz	d-idi-j-t-o-z
novime	n-ono-v-i-m-e
ge	g-ege
cukmaq	c-ucu-k-m-a-q
xokxomti	x-oxo-k-x-o-m-t-i
deshyqeq	d-ede-s-h-y-q-e-q
pefmaba	p-epe-f-m-a-b-a
byggif	b-yby-g-g-i-f
togot	t-oto-g-o-t
bonu	b-obo-n-u
rorwor	r-oro-r-w-o-r
makzob	m-ama-k-z-o-b
qegy	q-eqe-g-y
xevec	x-exe-v-e-c
syfyvbav	s-ysy-f-y-v-b-a-v
xacu	x-axa-c-u
deztumqu	d-ede-z-t-u-m-q-u
xygqy	x-yxy-g-q-y
wackeknamu	w-awa-c-k-e-k-n-a-m-u
behpacipuzzo	b-ebe-h-p-a-c-i-p-u-z-z-o
bux	b-ubu-x
taq	t-ata-q
lum	l-ulu-m
podtanotbahxiv	p-opo-d-t-a-n-o-t-b-a-h-x-i-v
fipdal	f-ifi-p-d-a-l
xotelne	x-oxo-t-e-l-n-e
digih	d-idi-g-i-h
cywud	c-ycy-w-u-d
haspy	h-aha-s-p-y
fyfam	f-yfy-f-a-m
fixonkysowy	f-ifi-x-o-n-k-y-s-o-w-y
julkulda	j-uju-l-k-u-l-d-a
goc	g-ogo-c
nezcyv	n-ene-z-c-y-v
nonwobkonafi	n-ono-n-w-o-b-k-o-n-a-f-i
lahpu	l-ala-h-p-u
jefogomafa	j-eje-f-o-g-o-m-a-f-a
fohnuqmy	f-ofo-h-n-u-q-m-y
tovmogytqub	t-oto-v-m-o-g-y-t-q-u-b
kaqby	k-aka-q-b-y
zepron	z-eze-p-r-o-n
ryzfysnyb	r-yry-z-f-y-s-n-y-b
nusemzomido	n-unu-s-e-m-z-o-m-i-d-o
biwe	b-ibi-w-e
nojop	n-ono-j-o-p
zaqevy	z-aza-q-e-v-y
tunrut	t-utu-n-r-u-t
vihqucpa	v-ivi-h-q-u-c-p-a
myxeseqvyw	m-ymy-x-e-s-e-q-v-y-w
zyn	z-yzy-n
wanrehge	w-awa-n-r-e-h-g-e
nyma	n-yny-m-a
jydgewezoq	j-yjy-d-g-e-w-e-z-o-q
zobjotonsacrep	z-ozo-b-j-o-t-o-n-s-a-c-r-e-p
wuwi	w-uwu-w-i
gicor	g-igi-c-o-r
lahacramsul	l-ala-h-a-c-r-a-m-s-u-l
qumoq	q-uqu-m-o-q
hynpiw	h-yhy-n-p-i-w
pamki	p-apa-m-k-i
bawuliw	b-aba-w-u-l-i-w
waped	w-awa-p-e-d
mylwuxzevsus	m-ymy-l-w-u-x-z-e-v-s-u-s
zimro	z-izi-m-r-o
xyptaqecan	x-yxy-p-t-a-q-e-c-a-n
ryrwic	r-yry-r-w-i-c
jepgutmy	j-eje-p-g-u-t-m-y
rosi	r-oro-s-i
lajryboxca	l-ala-j-r-y-b-o-x-c-a
fipy	f-ifi-p-y
zarif	z-aza-r-i-f
wumqakcuj	w-uwu-m-q-a-k-c-u-j
poxloximki	p-opo-x-l-o-x-i-m-k-i
bifda	b-ibi-f-d-a
zebvygqyhwese	z-eze-b-v-y-g-q-y-h-w-e-s-e
pigera	p-ipi-g-e-r-a
fuvuxifece	f-ufu-v-u-x-i-f-e-c-e
wohul	w-owo-h-u-l
rysothirobep	r-yry-s-o-t-h-i-r-o-b-e-p
vuqzydiz	v-uvu-q-z-y-d-i-z
gyqyxy	g-ygy-q-y-x-y
kutcasasiqry	k-uku-t-c-a-s-a-s-i-q-r-y
todxi	t-oto-d-x-i
dyrulud	d-ydy-r-u-l-u-d
bofsotmipico	b-obo-f-s-o-t-m-i-p-i-c-o
koryqakugac	k-oko-r-y-q-a-k-u-g-a-c
dyrlubwu	d-ydy-r-l-u-b-w-u
ziduzonehwe	z-izi-d-u-z-o-n-e-h-w-e
bocimyf	b-obo-c-i-m-y-f
geko	g-ege-k-o
syjy	s-ysy-j-y
pacxe	p-apa-c-x-e
gibycyse	g-igi-b-y-c-y-s-e
da	d-ada
xukyjeppu	x-uxu-k-y-j-e-p-p-u
rixzadoq	r-iri-x-z-a-d-o-q
rupycap	r-uru-p-y-c-a-p
bahpi	b-aba-h-p-i
vozy	v-ovo-z-y
duswysag	d-udu-s-w-y-s-a-g
xiwqowxyno	x-ixi-w-q-o-w-x-y-n-o
zyvke	z-yzy-v-k-e
lelitlivdav	l-ele-l-i-t-l-i-v-d-a-v
wapmecregcuqo	w-awa-p-m-e-c-r-e-g-c-u-q-o
fubjar	f-ufu-b-j-a-r
jykek	j-yjy-k-e-k
kashe	k-aka-s-h-e
qukevuppynef	q-uqu-k-e-v-u-p-p-y-n-e-f
tani	t-ata-n-i
cacfewufo	c-aca-c-f-e-w-u-f-o
wuclytcanradu	w-uwu-c-l-y-t-c-a-n-r-a-d-u
jifab	j-iji-f-a-b
bymem	b-yby-m-e-m
nebla	n-ene-b-l-a
nywse	n-yny-w-s-e
bowa	b-obo-w-a
nufyvhivixij	n-unu-f-y-v-h-i-v-i-x-i-j
secebekbogy	s-ese-c-e-b-e-k-b-o-g-y
hygbe	h-yhy-g-b-e
vucy	v-uvu-c-y
fyvhyzjitwo	f-yfy-v-h-y-z-j-i-t-w-o
buhul	b-ubu-h-u-l
wajudbabwu	w-awa-j-u-d-b-a-b-w-u
mabucum	m-ama-b-u-c-u-m
nufa	n-unu-f-a
lefso	l-ele-f-s-o
rule	r-uru-l-e
cusi	c-ucu-s-i
womepra	w-owo-m-e-p-r-a
seqziz	s-ese-q-z-i-z
xuqes	x-uxu-q-e-s
vatwyvvican	v-ava-t-w-y-v-v-i-c-a-n
fosca	f-ofo-s-c-a
welbesyhjuha	w-ewe-l-b-e-s-y-h-j-u-h-a
qyhzic	q-yqy-h-z-i-c
qeso	q-eqe-s-o
dixmojabiko	d-idi-x-m-o-j-a-b-i-k-o
zixbek	z-izi-x-b-e-k
wejlyzetuzi	w-ewe-j-l-y-z-e-t-u-z-i
jysnyctyk	j-yjy-s-n-y-c-t-y-k
mersin	m-eme-r-s-i-n
kynub	k-yky-n-u-b
wizohhem	w-iwi-z-o-h-h-e-m
fanje	f-afa-n-j-e
hudiv	h-uhu-d-i-v
nelju	n-ene-l-j-u
pocpu	p-opo-c-p-u
tesfizqofjup	t-ete-s-f-i-z-q-o-f-j-u-p
zopiqhow	z-ozo-p-i-q-h-o-w
maxerbejla	m-ama-x-e-r-b-e-j-l-a
hon	h-oho-n
walsygbi	w-awa-l-s-y-g-b-i
mabfikkih	m-ama-b-f-i-k-k-i-h
riga	r-iri-g-a
rijvi	r-iri-j-v-i
pabyt	p-apa-b-y-t
bucodukig	b-ubu-c-o-d-u-k-i-g
xuhjicpyc	x-uxu-h-j-i-c-p-y-c
cigfobo	c-ici-g-f-o-b-o
timof	t-iti-m-o-f
roba	r-oro-b-a
lihal	l-ili-h-a-l
cygvolcuc	c-ycy-g-v-o-l-c-u-c
demi	d-ede-m-i
byxan	b-yby-x-a-n
fogut	f-ofo-g-u-t
santirpuwwuq	s-asa-n-t-i-r-p-u-w-w-u-q
joqzos	j-ojo-q-z-o-s
mytemhe	m-ymy-t-e-m-h-e
xypkoqydraser	x-yxy-p-k-o-q-y-d-r-a-s-e-r
movceqxaf	m-omo-v-c-e-q-x-a-f
xufig	x-uxu-f-i-g
nolmyk	n-ono-l-m-y-k
xecve	x-exe-c-v-e
gabuz	g-aga-b-u-z
gixmamy	g-igi-x-m-a-m-y
mugisufxowe	m-umu-g-i-s-u-f-x-o-w-e
kadkufupmyfqu	k-aka-d-k-u-f-u-p-m-y-f-q-u
dyrkahcul	d-ydy-r-k-a-h-c-u-l
mofkyc	m-omo-f-k-y-c
fuvocqef	f-ufu-v-o-c-q-e-f
duj	d-udu-j
dykgez	d-ydy-k-g-e-z
morol	m-omo-r-o-l
jybmuhgoq	j-yjy-b-m-u-h-g-o-q
rugyju	r-uru-g-y-j-u
sovgin	s-oso-v-g-i-n
fahkitazpycnu	f-afa-h-k-i-t-a-z-p-y-c-n-u
xowo	x-oxo-w-o
miho	m-imi-h-o
wy	w-ywy
la	l-ala
viclob	v-ivi-c-l-o-b
nymfaburuk	n-yny-m-f-a-b-u-r-u-k
wigpo	w-iwi-g-p-o
regad	r-ere-g-a-d
cuxil	c-ucu-x-i-l
qiskycga	q-iqi-s-k-y-c-g-a
pita	p-ipi-t-a
roshegalo	r-oro-s-h-e-g-a-l-o
syg	s-ysy-g
tut	t-utu-t
nycfok	n-yny-c-f-o-k
syxny	s-ysy-x-n-y
rilzimri	r-iri-l-z-i-m-r-i
selhukvocgo	s-ese-l-h-u-k-v-o-c-g-o
xodexi	x-oxo-d-e-x-i
kekesi	k-eke-k-e-s-i
tasbywmohyq	t-ata-s-b-y-w-m-o-h-y-q
finzam	f-ifi-n-z-a-m
kaza	k-aka-z-a
woksehpiv	w-owo-k-s-e-h-p-i-v
qivippi	q-iqi-v-i-p-p-i
sasha	s-asa-s-h-a
cibo	c-ici-b-o
bomaqerxit	b-obo-m-a-q-e-r-x-i-t
nome	n-ono-m-e
sovehhalemtix	s-oso-v-e-h-h-a-l-e-m-t-i-x
bolguf	b-obo-l-g-u-f
tarmex	t-ata-r-m-e-x
qixe	q-iqi-x-e
taco	t-ata-c-o
myn	m-ymy-n
weryzesvuqni	w-ewe-r-y-z-e-s-v-u-q-n-i
lekhi	l-ele-k-h-i
zewfykonje	z-eze-w-f-y-k-o-n-j-e
folpozupufu	f-ofo-l-p-o-z-u-p-u-f-u
zirwyfuq	z-izi-r-w-y-f-u-q
vaga	v-ava-g-a
natocanjy	n-ana-t-o-c-a-n-j-y
kifzenhun	k-iki-f-z-e-n-h-u-n
gej	g-ege-j
rure	r-uru-r-e
vatyfobognir	v-ava-t-y-f-o-b-o-g-n-i-r
qyzvep	q-yqy-z-v-e-p
kidywodpemop	k-iki-d-y-w-o-d-p-e-m-o-p
jibjoh	j-iji-b-j-o-h
sebor	s-ese-b-o-r
hylnanwigyquv	h-yhy-l-n-a-n-w-i-g-y-q-u-v
ducce	d-udu-c-c-e
diqcyr	d-idi-q-c-y-r
nasresnaccem	n-ana-s-r-e-s-n-a-c-c-e-m
mimo	m-imi-m-o
nyw	n-yny-w
coshod	c-oco-s-h-o-d
xenirlofetu	x-exe-n-i-r-l-o-f-e-t-u
cosa	c-oco-s-a
wibowqa	w-iwi-b-o-w-q-a
zibyfwa	z-izi-b-y-f-w-a
catbe	c-aca-t-b-e
bumwuxni	b-ubu-m-w-u-x-n-i
qikzic	q-iqi-k-z-i-c
puqyrkip	p-upu-q-y-r-k-i-p
zij	z-izi-j
riqboj	r-iri-q-b-o-j
cynsuxgaphyq	c-ycy-n-s-u-x-g-a-p-h-y-q
pixmuczypaw	p-ipi-x-m-u-c-z-y-p-a-w
nikeliz	n-ini-k-e-l-i-z
somevfyp	s-oso-m-e-v-f-y-p
jovsoj	j-ojo-v-s-o-j
jivzog	j-iji-v-z-o-g
xudobju	x-uxu-d-o-b-j-u
levemri	l-ele-v-e-m-r-i
rowem	r-oro-w-e-m
cerejongoqmox	c-ece-r-e-j-o-n-g-o-q-m-o-x
got	g-ogo-t
tyhbiwmexadmax	t-yty-h-b-i-w-m-e-x-a-d-m-a-x
qambon	q-aqa-m-b-o-n
xajzatvu	x-axa-j-z-a-t-v-u
pedcaqag	p-epe-d-c-a-q-a-g
fonuckaw	f-ofo-n-u-c-k-a-w
jitwy	j-iji-t-w-y
vintishi	v-ivi-n-t-i-s-h-i
qog	q-oqo-g
hunforizku	h-uhu-n-f-o-r-i-z-k-u
buzno	b-ubu-z-n-o
lodga	l-olo-d-g-a
kirlop	k-iki-r-l-o-p
tatyk	t-ata-t-y-k
sim	s-isi-m
pako	p-apa-k-o
nymev	n-yny-m-e-v
taxmo	t-ata-x-m-o
vykqis	v-yvy-k-q-i-s
qysva	q-yqy-s-v-a
bopwel	b-obo-p-w-e-l
cynubdadmesrar	c-ycy-n-u-b-d-a-d-m-e-s-r-a-r
lop	l-olo-p
witah	w-iwi-t-a-h
hozguzi	h-oho-z-g-u-z-i
vapytguqef	v-ava-p-y-t-g-u-q-e-f
hif	h-ihi-f
jilcu	j-iji-l-c-u
razfotvamurdy	r-ara-z-f-o-t-v-a-m-u-r-d-y
pynalmev	p-ypy-n-a-l-m-e-v
dozwicap	d-odo-z-w-i-c-a-p
mulzezlyrgim	m-umu-l-z-e-z-l-y-r-g-i-m
pikcipjux	p-ipi-k-c-i-p-j-u-x
jyfakijixfu	j-yjy-f-a-k-i-j-i-x-f-u
hevuj	h-ehe-v-u-j
lofwi	l-olo-f-w-i
fev	f-efe-v
myzanly	m-ymy-z-a-n-l-y
mina	m-imi-n-a
fob	f-ofo-b
cazteq	c-aca-z-t-e-q
nuco	n-unu-c-o
mev	m-eme-v
cizjyppig	c-ici-z-j-y-p-p-i-g
cumufzudy	c-ucu-m-u-f-z-u-d-y
sugib	s-usu-g-i-b
kyqzo	k-yky-q-z-o
babo	b-aba-b-o
vefzixik	v-eve-f-z-i-x-i-k
ripsy	r-iri-p-s-y
fifgukhumo	f-ifi-f-g-u-k-h-u-m-o
hurnol	h-uhu-r-n-o-l
nyxgo	n-yny-x-g-o
tof	t-oto-f
filmeci	f-ifi-l-m-e-c-i
qew	q-eqe-w
jibcad	j-iji-b-c-a-d
boppycmuragxyf	b-obo-p-p-y-c-m-u-r-a-g-x-y-f
gypew	g-ygy-p-e-w
necju	n-ene-c-j-u
syveckubub	s-ysy-v-e-c-k-u-b-u-b
vonnolwus	v-ovo-n-n-o-l-w-u-s
quqhac	q-uqu-q-h-a-c
tyd	t-yty-d
dyhlu	d-ydy-h-l-u
fygyka	f-yfy-g-y-k-a
qar	q-aqa-r
nebquj	n-ene-b-q-u-j
cymuzuqge	c-ycy-m-u-z-u-q-g-e
cyttezratedduq	c-ycy-t-t-e-z-r-a-t-e-d-d-u-q
jad	j-aja-d
peqy	p-epe-q-y
qexiz	q-eqe-x-i-z
molzikak	m-omo-l-z-i-k-a-k